"yearweek","q3","q1","q2","survey_date","total_attacks","attacks_located_IL","attacks_located_yesha","attacks_target_civilian","attacks_target_security_forces","total_killed","killed_located_IL","killed_located_yesha","killed_target_civilian","killed_target_security_forces","intifada","mean(temperature)","mean(humidity)","week_range"
"2001-W30",2.19284294234592,3.14115308151093,3.62226640159046,2001-07-31,0,0,0,0,0,0,0,0,0,0,1,27.4660714285714,68.5357142857143,NA
"2001-W31",NA,NA,NA,NA,4,2,2,4,0,16,14,2,16,0,1,28.15,72.3392857142857,"2001-08-05 UTC--2001-08-11 UTC"
"2001-W32",NA,NA,NA,NA,0,0,0,0,0,0,0,0,0,0,1,27.9875,67.8392857142857,NA
"2001-W33",NA,NA,NA,NA,2,0,2,1,1,6,0,6,3,3,1,27.1625,65.5357142857143,"2001-08-19 UTC--2001-08-25 UTC"
"2001-W34",2.38627450980392,3.37843137254902,3.86666666666667,2001-08-30,4,0,4,4,0,4,0,4,4,0,1,27.2071428571429,68.1785714285714,"2001-08-26 UTC--2001-09-01 UTC"
"2001-W35",NA,NA,NA,NA,0,0,0,0,0,0,0,0,0,0,1,27.4839285714286,65.2321428571429,NA
"2001-W36",NA,NA,NA,NA,5,1,4,4,1,9,3,6,7,2,1,26.0589285714286,61.875,"2001-09-09 UTC--2001-09-15 UTC"
"2001-W37",NA,NA,NA,NA,2,0,2,1,1,2,0,2,1,1,1,25.0946428571429,67.8214285714286,"2001-09-16 UTC--2001-09-22 UTC"
"2001-W38",2.28458498023715,3.26679841897233,3.95256916996047,2001-09-26,2,1,1,2,0,2,1,1,2,0,1,25.3375,68.9821428571429,"2001-09-23 UTC--2001-09-29 UTC"
"2001-W39",NA,NA,NA,NA,3,1,2,3,0,6,3,3,6,0,1,24.5339285714286,63.5,"2001-09-30 UTC--2001-10-06 UTC"
"2001-W40",NA,NA,NA,NA,1,1,0,1,0,1,1,0,1,0,1,25.0545454545455,71.7636363636364,"2001-10-07 UTC--2001-10-13 UTC"
"2001-W41",NA,NA,NA,NA,2,0,2,2,0,2,0,2,2,0,1,23.6696428571429,65.9464285714286,"2001-10-14 UTC--2001-10-20 UTC"
"2001-W42",NA,NA,NA,NA,0,0,0,0,0,0,0,0,0,0,1,21.9803571428571,69.3928571428571,NA
"2001-W43",2.15079365079365,3.1547619047619,3.79761904761905,2001-10-31,3,2,1,2,1,6,5,1,5,1,1,20.1482142857143,65.7321428571429,"2001-10-28 UTC--2001-11-03 UTC"
"2001-W44",NA,NA,NA,NA,3,0,3,2,1,4,0,4,3,1,1,19.6571428571429,70.0892857142857,"2001-11-04 UTC--2001-11-10 UTC"
"2001-W45",NA,NA,NA,NA,1,1,0,1,0,1,1,0,1,0,1,20.0517857142857,63.5714285714286,"2001-11-11 UTC--2001-11-17 UTC"
"2001-W46",NA,NA,NA,NA,1,0,1,1,0,1,0,1,1,0,1,15.1464285714286,62.6071428571429,"2001-11-18 UTC--2001-11-24 UTC"
"2001-W47",2.1779497098646,3.03288201160542,3.77369439071567,2001-11-29,5,3,2,3,2,18,16,2,14,4,1,16.4839285714286,70.5,"2001-11-25 UTC--2001-12-01 UTC"
"2001-W48",NA,NA,NA,NA,2,1,1,2,0,15,14,1,15,0,1,15.1517857142857,64.1071428571429,"2001-12-02 UTC--2001-12-08 UTC"
"2001-W49",NA,NA,NA,NA,1,0,1,1,0,10,0,10,10,0,1,14.5464285714286,73.625,"2001-12-09 UTC--2001-12-15 UTC"
"2001-W50",NA,NA,NA,NA,0,0,0,0,0,0,0,0,0,0,1,12.3892857142857,73.6964285714286,NA
"2001-W51",NA,NA,NA,NA,0,0,0,0,0,0,0,0,0,0,1,14.7517857142857,73.3392857142857,NA
"2001-W52",2.18503937007874,3.14370078740157,3.70472440944882,2001-12-31,0,0,0,0,0,0,0,0,0,0,1,12.95625,65.4375,NA
"2002-W00",NA,NA,NA,NA,0,0,0,0,0,0,0,0,0,0,1,12.8025,62.05,NA
"2002-W01",NA,NA,NA,NA,1,1,0,1,0,4,4,0,4,0,1,9.34285714285714,76.0178571428571,"2002-01-06 UTC--2002-01-12 UTC"
"2002-W02",NA,NA,NA,NA,4,1,3,3,1,9,6,3,8,1,1,11.1607142857143,68.8035714285714,"2002-01-13 UTC--2002-01-19 UTC"
"2002-W03",NA,NA,NA,NA,1,1,0,1,0,2,2,0,2,0,1,11.8357142857143,69.5178571428571,"2002-01-20 UTC--2002-01-26 UTC"
"2002-W04",2.27380952380952,3.19444444444444,3.85912698412698,2002-01-31,1,1,0,1,0,1,1,0,1,0,1,12.675,71.4285714285714,"2002-01-27 UTC--2002-02-02 UTC"
"2002-W05",NA,NA,NA,NA,3,1,2,3,0,5,1,4,5,0,1,14.9178571428571,60.2142857142857,"2002-02-03 UTC--2002-02-09 UTC"
"2002-W06",NA,NA,NA,NA,3,1,2,2,1,8,2,6,5,3,1,14.1392857142857,77.7321428571429,"2002-02-10 UTC--2002-02-16 UTC"
"2002-W07",NA,NA,NA,NA,4,0,4,2,2,11,0,11,2,9,1,13.7,60.9464285714286,"2002-02-17 UTC--2002-02-23 UTC"
"2002-W08",2.09375,3.140625,3.728515625,2002-02-28,7,1,6,5,2,18,11,7,16,2,1,14.3875,64.9285714285714,"2002-02-24 UTC--2002-03-02 UTC"
"2002-W09",NA,NA,NA,NA,11,6,5,7,4,35,17,18,22,13,1,17.6411764705882,63.8235294117647,"2002-03-03 UTC--2002-03-09 UTC"
"2002-W10",NA,NA,NA,NA,4,0,4,2,2,6,0,6,2,4,1,18.2711538461538,62.9615384615385,"2002-03-10 UTC--2002-03-16 UTC"
"2002-W11",NA,NA,NA,NA,4,3,1,3,1,12,11,1,11,1,1,16.8207547169811,72.2641509433962,"2002-03-17 UTC--2002-03-23 UTC"
"2002-W12",1.97821782178218,3.06336633663366,3.67128712871287,2002-03-25,9,4,5,7,2,41,31,10,38,3,1,15.0196078431373,63.6078431372549,"2002-03-24 UTC--2002-03-30 UTC"
"2002-W13",NA,NA,NA,NA,7,2,5,3,4,26,16,10,17,9,1,17,61.6666666666667,"2002-03-31 UTC--2002-04-06 UTC"
"2002-W14",NA,NA,NA,NA,5,2,3,3,2,29,12,17,13,16,1,17.0901960784314,65.3333333333333,"2002-04-07 UTC--2002-04-13 UTC"
"2002-W15",NA,NA,NA,NA,1,0,1,1,0,1,0,1,1,0,1,21.1732142857143,55.7142857142857,"2002-04-14 UTC--2002-04-20 UTC"
"2002-W16",NA,3.34262948207171,3.83266932270916,2002-04-25,2,0,2,1,1,5,0,5,4,1,1,17.6928571428571,66.9642857142857,"2002-04-21 UTC--2002-04-27 UTC"
"2002-W17",NA,NA,NA,NA,1,0,1,0,1,1,0,1,0,1,1,17.811320754717,71.4716981132076,"2002-04-28 UTC--2002-05-04 UTC"
"2002-W18",NA,NA,NA,NA,1,1,0,1,0,15,15,0,15,0,1,20.0839285714286,67.2142857142857,"2002-05-05 UTC--2002-05-11 UTC"
"2002-W19",NA,NA,NA,NA,1,0,1,1,0,1,0,1,1,0,1,21.2535714285714,65.5892857142857,"2002-05-12 UTC--2002-05-18 UTC"
"2002-W20",NA,NA,NA,NA,3,2,1,2,1,6,5,1,5,1,1,21.3071428571429,68.6607142857143,"2002-05-19 UTC--2002-05-25 UTC"
"2002-W21",2.18181818181818,3.29051383399209,3.92094861660079,2002-05-31,3,1,2,3,0,6,2,4,6,0,1,22.5642857142857,69.75,"2002-05-26 UTC--2002-06-01 UTC"
"2002-W22",NA,NA,NA,NA,3,1,2,3,0,21,17,4,21,0,1,24.5089285714286,59.1071428571429,"2002-06-02 UTC--2002-06-08 UTC"
"2002-W23",NA,NA,NA,NA,2,1,1,1,1,4,1,3,1,3,1,25.5946428571429,66.25,"2002-06-09 UTC--2002-06-15 UTC"
"2002-W24",NA,NA,NA,NA,4,1,3,3,1,32,19,13,30,2,1,24.7288461538462,70.7115384615385,"2002-06-16 UTC--2002-06-22 UTC"
"2002-W25",NA,NA,NA,NA,0,0,0,0,0,0,0,0,0,0,1,25.4839285714286,70.5535714285714,NA
"2002-W26",2.32335329341317,3.23552894211577,3.66467065868263,2002-06-30,0,0,0,0,0,0,0,0,0,0,1,26.4472727272727,72.7090909090909,NA
"2002-W27",NA,NA,NA,NA,1,0,1,0,1,1,0,1,0,1,1,27.0946428571429,68.625,"2002-07-07 UTC--2002-07-13 UTC"
"2002-W28",NA,NA,NA,NA,3,1,2,2,1,12,2,10,11,1,1,28.1017857142857,73.4821428571429,"2002-07-14 UTC--2002-07-20 UTC"
"2002-W29",NA,NA,NA,NA,2,0,2,2,0,5,0,5,5,0,1,27.5946428571429,69.25,"2002-07-21 UTC--2002-07-27 UTC"
"2002-W30",2.1139489194499,3.16699410609037,3.83693516699411,2002-07-31,3,1,2,3,0,8,5,3,8,0,1,29.0851851851852,69.8518518518518,"2002-07-28 UTC--2002-08-03 UTC"
"2002-W31",NA,NA,NA,NA,4,1,3,4,0,11,7,4,11,0,1,28.2178571428571,72.6964285714286,"2002-08-04 UTC--2002-08-10 UTC"
"2002-W32",NA,NA,NA,NA,0,0,0,0,0,0,0,0,0,0,1,28.3607142857143,71.9464285714286,NA
"2002-W33",NA,NA,NA,NA,1,0,1,0,1,1,0,1,0,1,1,26.9142857142857,70.7678571428571,"2002-08-18 UTC--2002-08-24 UTC"
"2002-W34",2.13178294573643,3.20736434108527,3.80038759689922,2002-08-31,0,0,0,0,0,0,0,0,0,0,1,27.0767857142857,74.5178571428571,NA
"2002-W35",NA,NA,NA,NA,2,0,2,0,2,2,0,2,0,2,1,26.85,66.3571428571429,"2002-09-01 UTC--2002-09-07 UTC"
"2002-W36",NA,NA,NA,NA,0,0,0,0,0,0,0,0,0,0,1,26.2839285714286,65,NA
"2002-W37",NA,NA,NA,NA,4,2,2,4,0,8,6,2,8,0,1,26.6232142857143,61.1785714285714,"2002-09-15 UTC--2002-09-21 UTC"
"2002-W38",NA,NA,NA,NA,2,0,2,1,1,2,0,2,1,1,1,25.2125,72.5535714285714,"2002-09-22 UTC--2002-09-28 UTC"
"2002-W39",NA,3.06769825918762,3.65957446808511,2002-09-30,1,0,1,0,1,1,0,1,0,1,1,25.7327272727273,63.3818181818182,"2002-09-29 UTC--2002-10-05 UTC"
"2002-W40",NA,NA,NA,NA,2,1,1,2,0,2,1,1,2,0,1,24.4125,71.1785714285714,"2002-10-06 UTC--2002-10-12 UTC"
"2002-W41",NA,NA,NA,NA,0,0,0,0,0,0,0,0,0,0,1,23.7851851851852,76.5555555555556,NA
"2002-W42",NA,NA,NA,NA,1,1,0,1,0,13,13,0,13,0,1,22.6851851851852,73.4444444444444,"2002-10-20 UTC--2002-10-26 UTC"
"2002-W43",2.18774703557312,2.99407114624506,3.67193675889328,2002-10-30,2,0,2,2,0,6,0,6,6,0,1,21.4527272727273,71.6363636363636,"2002-10-27 UTC--2002-11-02 UTC"
"2002-W44",NA,NA,NA,NA,3,1,2,2,1,5,2,3,4,1,1,21.55,62.9285714285714,"2002-11-03 UTC--2002-11-09 UTC"
"2002-W45",NA,NA,NA,NA,2,1,1,2,0,17,5,12,17,0,1,19.6303571428571,61.6964285714286,"2002-11-10 UTC--2002-11-16 UTC"
"2002-W46",NA,NA,NA,NA,3,1,2,2,1,12,10,2,11,1,1,20.1821428571429,41.3214285714286,"2002-11-17 UTC--2002-11-23 UTC"
"2002-W47",2.13243761996161,3.1573896353167,3.71017274472169,2002-11-30,1,1,0,1,0,6,6,0,6,0,1,17.3964285714286,65.8214285714286,"2002-11-24 UTC--2002-11-30 UTC"
"2002-W48",NA,NA,NA,NA,0,0,0,0,0,0,0,0,0,0,1,17.2232142857143,69.3928571428571,NA
"2002-W49",NA,NA,NA,NA,1,0,1,0,1,2,0,2,0,2,1,15.4517857142857,67.0357142857143,"2002-12-08 UTC--2002-12-14 UTC"
"2002-W50",NA,NA,NA,NA,1,0,1,1,0,1,0,1,1,0,1,14.3285714285714,76.4642857142857,"2002-12-15 UTC--2002-12-21 UTC"
"2002-W51",NA,NA,NA,NA,1,0,1,1,0,4,0,4,4,0,1,13.1553571428571,83.1071428571429,"2002-12-22 UTC--2002-12-28 UTC"
"2002-W52",2.15643564356436,3.14455445544554,3.75049504950495,2002-12-31,0,0,0,0,0,0,0,0,0,0,1,14.1,77.1666666666667,NA
"2003-W00",NA,NA,NA,NA,1,0,1,1,0,1,0,1,1,0,1,14.15625,79.1875,"2002-12-29 UTC--2003-01-04 UTC"
"2003-W01",NA,NA,NA,NA,1,1,0,1,0,15,15,0,15,0,1,15.0777777777778,70.2222222222222,"2003-01-05 UTC--2003-01-11 UTC"
"2003-W02",NA,NA,NA,NA,3,2,1,2,1,3,2,1,2,1,1,15.1357142857143,70.7678571428571,"2003-01-12 UTC--2003-01-18 UTC"
"2003-W03",NA,NA,NA,NA,1,0,1,0,1,3,0,3,0,3,1,12.4857142857143,81.0357142857143,"2003-01-19 UTC--2003-01-25 UTC"
"2003-W04",2.13121272365805,3.23459244532803,3.69582504970179,2003-01-31,0,0,0,0,0,0,0,0,0,0,1,13.4589285714286,69.7678571428571,NA
"2003-W05",NA,NA,NA,NA,1,0,1,0,1,2,0,2,0,2,1,12.9203703703704,67.8518518518518,"2003-02-02 UTC--2003-02-08 UTC"
"2003-W06",NA,NA,NA,NA,2,0,2,0,2,6,0,6,0,6,1,12.1821428571429,80.7857142857143,"2003-02-09 UTC--2003-02-15 UTC"
"2003-W07",NA,NA,NA,NA,0,0,0,0,0,0,0,0,0,0,1,13.8607142857143,72.7321428571429,NA
"2003-W08",2.07509881422925,3.05928853754941,3.60671936758893,2003-02-28,1,0,1,0,1,1,0,1,0,1,1,11.0303571428571,78.4821428571429,"2003-02-23 UTC--2003-03-01 UTC"
"2003-W09",NA,NA,NA,NA,2,1,1,2,0,19,17,2,19,0,1,15.2875,69.9642857142857,"2003-03-02 UTC--2003-03-08 UTC"
"2003-W10",NA,NA,NA,NA,2,0,2,0,2,2,0,2,0,2,1,13.9732142857143,79.2678571428571,"2003-03-09 UTC--2003-03-15 UTC"
"2003-W11",NA,NA,NA,NA,2,0,2,1,1,2,0,2,1,1,1,14.1982142857143,78.0178571428571,"2003-03-16 UTC--2003-03-22 UTC"
"2003-W12",NA,NA,NA,NA,0,0,0,0,0,0,0,0,0,0,1,12.4178571428571,79.4107142857143,NA
"2003-W13",2.12749003984064,3.17330677290837,3.81075697211155,2003-03-31,0,0,0,0,0,0,0,0,0,0,1,20.0571428571429,64.625,NA
"2003-W14",NA,NA,NA,NA,1,0,1,0,1,2,0,2,0,2,1,17.5017857142857,74.2678571428571,"2003-04-06 UTC--2003-04-12 UTC"
"2003-W15",NA,NA,NA,NA,2,0,2,1,1,2,0,2,1,1,1,17.8285714285714,70.9642857142857,"2003-04-13 UTC--2003-04-19 UTC"
"2003-W16",NA,NA,NA,NA,2,1,1,1,1,2,1,1,1,1,1,19.0696428571429,63.7142857142857,"2003-04-20 UTC--2003-04-26 UTC"
"2003-W17",1.96274509803922,3.05098039215686,3.6,2003-04-30,0,0,0,0,0,0,0,0,0,0,1,19.5982142857143,60.9464285714286,NA
"2003-W18",NA,NA,NA,NA,1,0,1,1,0,1,0,1,1,0,1,25.7910714285714,48.75,"2003-05-04 UTC--2003-05-10 UTC"
"2003-W19",NA,NA,NA,NA,2,0,2,2,0,3,0,3,3,0,1,25.1380952380952,60.6666666666667,"2003-05-11 UTC--2003-05-17 UTC"
"2003-W20",NA,NA,NA,NA,2,1,1,2,0,9,3,6,9,0,1,23.1481481481481,70.5740740740741,"2003-05-18 UTC--2003-05-24 UTC"
"2003-W21",NA,3.13717693836978,3.56858846918489,2003-05-30,0,0,0,0,0,0,0,0,0,0,1,24.0160714285714,62.0714285714286,NA
"2003-W22",NA,NA,NA,NA,0,0,0,0,0,0,0,0,0,0,1,23.1696428571429,73.1071428571429,NA
"2003-W23",NA,NA,NA,NA,5,1,4,2,3,24,17,7,18,6,1,24.1517857142857,73.8214285714286,"2003-06-08 UTC--2003-06-14 UTC"
"2003-W24",NA,NA,NA,NA,3,2,1,3,0,3,2,1,3,0,1,25.7089285714286,68.25,"2003-06-15 UTC--2003-06-21 UTC"
"2003-W25",NA,NA,NA,NA,2,1,1,1,1,2,1,1,1,1,1,25.7672727272727,72.4181818181818,"2003-06-22 UTC--2003-06-28 UTC"
"2003-W26",NA,2.87225548902196,3.50898203592814,2003-06-30,0,0,0,0,0,0,0,0,0,0,1,26.7196428571429,71.9821428571429,NA
"2003-W27",NA,NA,NA,NA,1,1,0,1,0,1,1,0,1,0,1,26.7321428571429,67.6071428571429,"2003-07-06 UTC--2003-07-12 UTC"
"2003-W28",NA,NA,NA,NA,1,1,0,1,0,1,1,0,1,0,1,25.754,73.04,"2003-07-13 UTC--2003-07-19 UTC"
"2003-W29",NA,NA,NA,NA,0,0,0,0,0,0,0,0,0,0,1,26.868,72.38,NA
"2003-W30",1.93873517786561,3.00197628458498,3.45059288537549,2003-07-31,0,0,0,0,0,0,0,0,0,0,1,27.0410714285714,73.2142857142857,NA
"2003-W31",NA,NA,NA,NA,1,0,1,0,1,1,0,1,0,1,1,27.4035714285714,72.7321428571429,"2003-08-03 UTC--2003-08-09 UTC"
"2003-W32",NA,NA,NA,NA,2,1,1,2,0,3,1,2,3,0,1,27.7517857142857,71.4821428571429,"2003-08-10 UTC--2003-08-16 UTC"
"2003-W33",NA,NA,NA,NA,1,1,0,1,0,23,23,0,23,0,1,27.1910714285714,74.5357142857143,"2003-08-17 UTC--2003-08-23 UTC"
"2003-W34",NA,NA,NA,NA,1,0,1,1,0,1,0,1,1,0,1,26.9678571428571,72.8571428571429,"2003-08-24 UTC--2003-08-30 UTC"
"2003-W35",2.150390625,3.171875,3.9375,2003-08-31,2,0,2,0,2,2,0,2,0,2,1,27.3214285714286,66.5535714285714,"2003-08-31 UTC--2003-09-06 UTC"
"2003-W36",NA,NA,NA,NA,2,2,0,2,0,16,16,0,16,0,1,25.7267857142857,64.5,"2003-09-07 UTC--2003-09-13 UTC"
"2003-W37",NA,NA,NA,NA,0,0,0,0,0,0,0,0,0,0,1,25.3660714285714,67,NA
"2003-W38",NA,NA,NA,NA,2,0,2,1,1,3,0,3,2,1,1,24.3410714285714,68.9107142857143,"2003-09-21 UTC--2003-09-27 UTC"
"2003-W39",2.0875486381323,3.0408560311284,3.77821011673152,2003-09-30,1,1,0,1,0,21,21,0,21,0,1,23.8375,68.6428571428571,"2003-09-28 UTC--2003-10-04 UTC"
"2003-W40",NA,NA,NA,NA,0,0,0,0,0,0,0,0,0,0,1,24.3660714285714,73.4285714285714,NA
"2003-W41",NA,NA,NA,NA,0,0,0,0,0,0,0,0,0,0,1,21.9857142857143,69.8928571428571,NA
"2003-W42",NA,NA,NA,NA,2,0,2,0,2,6,0,6,0,6,1,23.5678571428571,72.25,"2003-10-19 UTC--2003-10-25 UTC"
"2003-W43",2.03571428571429,3.1984126984127,3.76388888888889,2003-10-30,0,0,0,0,0,0,0,0,0,0,1,22.2821428571429,63.4821428571429,NA
"2003-W44",NA,NA,NA,NA,0,0,0,0,0,0,0,0,0,0,1,21.9357142857143,74.8928571428571,NA
"2003-W45",NA,NA,NA,NA,0,0,0,0,0,0,0,0,0,0,1,17.825,73.0357142857143,NA
"2003-W46",NA,NA,NA,NA,2,0,2,1,1,4,0,4,2,2,1,17.4982142857143,69.9285714285714,"2003-11-16 UTC--2003-11-22 UTC"
"2003-W47",NA,NA,NA,NA,0,0,0,0,0,0,0,0,0,0,1,17.3732142857143,74.0892857142857,NA
"2003-W48",1.88062622309198,2.94911937377691,3.72602739726027,2003-11-30,0,0,0,0,0,0,0,0,0,0,1,14.5821428571429,84.3392857142857,NA
"2003-W49",NA,NA,NA,NA,0,0,0,0,0,0,0,0,0,0,1,15.875,71.375,NA
"2003-W50",NA,NA,NA,NA,0,0,0,0,0,0,0,0,0,0,1,15.5,69.4107142857143,NA
"2003-W51",NA,NA,NA,NA,2,1,1,1,1,6,4,2,4,2,1,13.1517857142857,64.6607142857143,"2003-12-21 UTC--2003-12-27 UTC"
"2003-W52",2.01571709233792,3.13948919449902,3.69548133595285,2003-12-31,0,0,0,0,0,0,0,0,0,0,1,13.484375,71.6875,NA
"2004-W00",NA,NA,NA,NA,0,0,0,0,0,0,0,0,0,0,1,12.359375,74.78125,NA
"2004-W01",NA,NA,NA,NA,0,0,0,0,0,0,0,0,0,0,1,11.8267857142857,79.4285714285714,NA
"2004-W02",NA,NA,NA,NA,2,0,2,1,1,5,0,5,1,4,1,13.3660714285714,81.2321428571429,"2004-01-11 UTC--2004-01-17 UTC"
"2004-W03",NA,NA,NA,NA,0,0,0,0,0,0,0,0,0,0,1,12.7964285714286,74.2678571428571,NA
"2004-W04",1.94234592445328,2.98807157057654,3.779324055666,2004-01-29,1,1,0,1,0,11,11,0,11,0,1,12.8535714285714,72.5892857142857,"2004-01-25 UTC--2004-01-31 UTC"
"2004-W05",NA,NA,NA,NA,0,0,0,0,0,0,0,0,0,0,1,12.1785714285714,80.9821428571429,NA
"2004-W06",NA,NA,NA,NA,0,0,0,0,0,0,0,0,0,0,1,13.4642857142857,77,NA
"2004-W07",NA,NA,NA,NA,0,0,0,0,0,0,0,0,0,0,1,12.3517857142857,76.5714285714286,NA
"2004-W08",NA,NA,NA,NA,3,2,1,2,1,11,10,1,10,1,1,14.5714285714286,69.2678571428571,"2004-02-22 UTC--2004-02-28 UTC"
"2004-W09",2.12156862745098,3.14705882352941,3.84705882352941,2004-02-29,0,0,0,0,0,0,0,0,0,0,1,20.7232142857143,60.3928571428571,NA
"2004-W10",NA,NA,NA,NA,0,0,0,0,0,0,0,0,0,0,1,13.5857142857143,72.3035714285714,NA
"2004-W11",NA,NA,NA,NA,2,1,1,2,0,11,10,1,11,0,1,12.9285714285714,69.0178571428571,"2004-03-14 UTC--2004-03-20 UTC"
"2004-W12",NA,NA,NA,NA,0,0,0,0,0,0,0,0,0,0,1,17.6928571428571,63.4821428571429,NA
"2004-W13",2.11857707509881,2.98616600790514,3.72727272727273,2004-03-31,1,0,1,1,0,1,0,1,1,0,1,18.1553571428571,76.6607142857143,"2004-03-28 UTC--2004-04-03 UTC"
"2004-W14",NA,NA,NA,NA,0,0,0,0,0,0,0,0,0,0,1,16.3267857142857,72.5357142857143,NA
"2004-W15",NA,NA,NA,NA,1,1,0,0,1,1,1,0,0,1,1,17.9321428571429,65.625,"2004-04-11 UTC--2004-04-17 UTC"
"2004-W16",NA,NA,NA,NA,0,0,0,0,0,0,0,0,0,0,1,18.1375,66.875,NA
"2004-W17",2.13725490196078,3.06862745098039,3.76078431372549,2004-04-30,1,0,1,0,1,1,0,1,0,1,1,20.2839285714286,59.3035714285714,"2004-04-25 UTC--2004-05-01 UTC"
"2004-W18",NA,NA,NA,NA,1,0,1,1,0,5,0,5,5,0,1,21.5660714285714,64.8571428571429,"2004-05-02 UTC--2004-05-08 UTC"
"2004-W19",NA,NA,NA,NA,3,0,3,0,3,13,0,13,0,13,1,22.4839285714286,59.6785714285714,"2004-05-09 UTC--2004-05-15 UTC"
"2004-W20",NA,NA,NA,NA,0,0,0,0,0,0,0,0,0,0,1,20.4857142857143,62.8392857142857,NA
"2004-W21",NA,NA,NA,NA,1,0,1,0,1,1,0,1,0,1,1,20.3625,70.4464285714286,"2004-05-23 UTC--2004-05-29 UTC"
"2004-W22",1.98651252408478,2.88824662813102,3.59922928709056,2004-05-31,0,0,0,0,0,0,0,0,0,0,1,22.275,67.8392857142857,NA
"2004-W23",NA,NA,NA,NA,0,0,0,0,0,0,0,0,0,0,1,23.2696428571429,70.375,NA
"2004-W24",NA,NA,NA,NA,0,0,0,0,0,0,0,0,0,0,1,24.5071428571429,73.6785714285714,NA
"2004-W25",NA,NA,NA,NA,0,0,0,0,0,0,0,0,0,0,1,24.7963636363636,71.6545454545455,NA
"2004-W26",1.96660117878193,2.83889980353635,3.54616895874263,2004-06-30,3,1,2,2,1,4,2,2,3,1,1,25.5017857142857,72.0714285714286,"2004-06-27 UTC--2004-07-03 UTC"
"2004-W27",NA,NA,NA,NA,2,0,2,1,1,2,0,2,1,1,1,26.5053571428571,74.5,"2004-07-04 UTC--2004-07-10 UTC"
"2004-W28",NA,NA,NA,NA,1,1,0,1,0,1,1,0,1,0,1,27.2785714285714,69.3571428571429,"2004-07-11 UTC--2004-07-17 UTC"
"2004-W29",NA,NA,NA,NA,0,0,0,0,0,0,0,0,0,0,1,26.5053571428571,71.0714285714286,NA
"2004-W30",2.18613861386139,3.13069306930693,3.73465346534653,2004-07-31,0,0,0,0,0,0,0,0,0,0,1,27.1571428571429,73.2857142857143,NA
"2004-W31",NA,NA,NA,NA,0,0,0,0,0,0,0,0,0,0,1,27.1,69.1964285714286,NA
"2004-W32",NA,NA,NA,NA,1,0,1,1,0,1,0,1,1,0,1,27.1660714285714,71.0178571428571,"2004-08-08 UTC--2004-08-14 UTC"
"2004-W33",NA,NA,NA,NA,0,0,0,0,0,0,0,0,0,0,1,26.5811320754717,70.8301886792453,NA
"2004-W34",NA,NA,NA,NA,0,0,0,0,0,0,0,0,0,0,1,26.7571428571429,74.2678571428571,NA
"2004-W35",2.04166666666667,2.9265873015873,3.6031746031746,2004-08-31,1,1,0,1,0,16,16,0,16,0,1,26.2714285714286,69.1785714285714,"2004-08-29 UTC--2004-09-04 UTC"
"2004-W36",NA,NA,NA,NA,0,0,0,0,0,0,0,0,0,0,1,26.3696428571429,69,NA
"2004-W37",NA,NA,NA,NA,0,0,0,0,0,0,0,0,0,0,1,24.3035714285714,66.9107142857143,NA
"2004-W38",NA,NA,NA,NA,3,0,3,2,1,6,0,6,3,3,1,24.9196428571429,74.3928571428571,"2004-09-19 UTC--2004-09-25 UTC"
"2004-W39",2.00757575757576,2.87121212121212,3.57954545454545,2004-09-28,3,1,2,2,1,5,2,3,4,1,1,25.4035714285714,78.3928571428571,"2004-09-26 UTC--2004-10-02 UTC"
"2004-W40",NA,NA,NA,NA,0,0,0,0,0,0,0,0,0,0,1,23.225,69.9642857142857,NA
"2004-W41",NA,NA,NA,NA,0,0,0,0,0,0,0,0,0,0,1,24.0660714285714,72.7678571428571,NA
"2004-W42",NA,NA,NA,NA,2,0,2,0,2,2,0,2,0,2,1,23.4357142857143,77.3571428571429,"2004-10-17 UTC--2004-10-23 UTC"
"2004-W43",2.00394477317554,2.96646942800789,3.59960552268245,2004-10-30,1,0,1,0,1,1,0,1,0,1,1,23.3160714285714,74.5,"2004-10-24 UTC--2004-10-30 UTC"
"2004-W44",NA,NA,NA,NA,1,1,0,1,0,3,3,0,3,0,1,23.0254545454545,58.0545454545455,"2004-10-31 UTC--2004-11-06 UTC"
"2004-W45",NA,NA,NA,NA,0,0,0,0,0,0,0,0,0,0,1,20.6107142857143,70.0714285714286,NA
"2004-W46",NA,NA,NA,NA,0,0,0,0,0,0,0,0,0,0,1,20.2625,68.3035714285714,NA
"2004-W47",NA,NA,NA,NA,0,0,0,0,0,0,0,0,0,0,1,15.1264150943396,61.9245283018868,NA
"2004-W48",1.92745098039216,3.02549019607843,3.62156862745098,2004-11-30,0,0,0,0,0,0,0,0,0,0,1,13.9214285714286,57.875,NA
"2004-W49",NA,NA,NA,NA,1,0,1,1,0,1,0,1,1,0,1,14.5053571428571,69.4285714285714,"2004-12-05 UTC--2004-12-11 UTC"
"2004-W50",NA,NA,NA,NA,1,0,1,0,1,5,0,5,0,5,1,10.4982142857143,68.8928571428571,"2004-12-12 UTC--2004-12-18 UTC"
"2004-W51",NA,NA,NA,NA,2,1,1,2,0,2,1,1,2,0,1,12.8892857142857,78.8392857142857,"2004-12-19 UTC--2004-12-25 UTC"
"2004-W52",1.87861271676301,2.8150289017341,3.51637764932563,2004-12-29,0,0,0,0,0,0,0,0,0,0,1,13.2604166666667,75.4375,NA
"2005-W00",NA,NA,NA,NA,0,0,0,0,0,0,0,0,0,0,1,14.15,81.125,NA
"2005-W01",NA,NA,NA,NA,3,2,1,3,0,4,2,2,4,0,1,12.4464285714286,79.3392857142857,"2005-01-02 UTC--2005-01-08 UTC"
"2005-W02",NA,NA,NA,NA,3,1,2,3,0,8,1,7,8,0,1,11.8035714285714,70.1071428571429,"2005-01-09 UTC--2005-01-15 UTC"
"2005-W03",NA,NA,NA,NA,1,0,1,1,0,1,0,1,1,0,1,11.265306122449,75.5918367346939,"2005-01-16 UTC--2005-01-22 UTC"
"2005-W04",NA,NA,NA,NA,0,0,0,0,0,0,0,0,0,0,1,13.8071428571429,69.4642857142857,NA
"2005-W05",1.78149606299213,2.75590551181102,3.27952755905512,2005-01-31,0,0,0,0,0,0,0,0,0,0,1,13.6946428571429,74,NA
"2005-W06",NA,NA,NA,NA,0,0,0,0,0,0,0,0,0,0,1,9.72321428571429,79.4821428571429,NA
"2005-W07",NA,NA,NA,NA,0,0,0,0,0,0,0,0,0,0,0,14.9636363636364,67.0363636363636,NA
"2005-W08",NA,NA,NA,NA,1,1,0,1,0,5,5,0,5,0,0,14.0839285714286,79.4464285714286,"2005-02-20 UTC--2005-02-26 UTC"
"2005-W09",1.84842519685039,2.76771653543307,3.29527559055118,2005-02-27,0,0,0,0,0,0,0,0,0,0,0,17.1964285714286,59.875,NA
"2005-W10",NA,NA,NA,NA,0,0,0,0,0,0,0,0,0,0,0,15.5142857142857,73.2321428571429,NA
"2005-W11",NA,NA,NA,NA,0,0,0,0,0,0,0,0,0,0,0,13.6714285714286,73.4821428571429,NA
"2005-W12",NA,NA,NA,NA,0,0,0,0,0,0,0,0,0,0,0,14.5785714285714,72.0357142857143,NA
"2005-W13",1.86105675146771,2.73385518590998,3.3307240704501,2005-03-31,0,0,0,0,0,0,0,0,0,0,0,17.0910714285714,70.7678571428571,NA
"2005-W14",NA,NA,NA,NA,0,0,0,0,0,0,0,0,0,0,0,16.775,65.4642857142857,NA
"2005-W15",NA,NA,NA,NA,0,0,0,0,0,0,0,0,0,0,0,20.5708333333333,59.9791666666667,NA
"2005-W16",NA,NA,NA,NA,0,0,0,0,0,0,0,0,0,0,0,21.3053571428571,61.9464285714286,NA
"2005-W17",1.95266272189349,2.82248520710059,3.33727810650888,2005-04-30,0,0,0,0,0,0,0,0,0,0,0,18.0767857142857,74.0535714285714,NA
"2005-W18",NA,NA,NA,NA,1,0,1,0,1,1,0,1,0,1,0,18.7410714285714,71.1071428571429,"2005-05-01 UTC--2005-05-07 UTC"
"2005-W19",NA,NA,NA,NA,0,0,0,0,0,0,0,0,0,0,0,19.9927272727273,73.1272727272727,NA
"2005-W20",NA,NA,NA,NA,0,0,0,0,0,0,0,0,0,0,0,21.9178571428571,75.4642857142857,NA
"2005-W21",NA,NA,NA,NA,0,0,0,0,0,0,0,0,0,0,0,22.1464285714286,68.9642857142857,NA
"2005-W22",1.87007874015748,2.78543307086614,3.35826771653543,2005-05-31,0,0,0,0,0,0,0,0,0,0,0,22.6625,70.7678571428571,NA
"2005-W23",NA,NA,NA,NA,0,0,0,0,0,0,0,0,0,0,0,23.4339285714286,73.0892857142857,NA
"2005-W24",NA,NA,NA,NA,0,0,0,0,0,0,0,0,0,0,0,24.4053571428571,68.25,NA
"2005-W25",NA,NA,NA,NA,3,0,3,2,1,4,0,4,3,1,0,25.6160714285714,68.4285714285714,"2005-06-19 UTC--2005-06-25 UTC"
"2005-W26",1.90836653386454,2.82270916334661,3.47211155378486,2005-06-30,0,0,0,0,0,0,0,0,0,0,0,25.025,72.1428571428571,NA
"2005-W27",NA,NA,NA,NA,0,0,0,0,0,0,0,0,0,0,0,25.8839285714286,71.6071428571429,NA
"2005-W28",NA,NA,NA,NA,2,2,0,2,0,6,6,0,6,0,0,26.5375,73.3214285714286,"2005-07-10 UTC--2005-07-16 UTC"
"2005-W29",NA,NA,NA,NA,0,0,0,0,0,0,0,0,0,0,0,27.0125,74.3928571428571,NA
"2005-W30",NA,NA,NA,NA,1,0,1,1,0,2,0,2,2,0,0,27.2017857142857,72.8392857142857,"2005-07-24 UTC--2005-07-30 UTC"
"2005-W31",2.04752475247525,2.82178217821782,3.63960396039604,2005-07-31,0,0,0,0,0,0,0,0,0,0,0,27.8267857142857,70.8928571428571,NA
"2005-W32",NA,NA,NA,NA,0,0,0,0,0,0,0,0,0,0,0,27.3214285714286,65.875,NA
"2005-W33",NA,NA,NA,NA,0,0,0,0,0,0,0,0,0,0,0,27.4037037037037,71.2222222222222,NA
"2005-W34",NA,NA,NA,NA,0,0,0,0,0,0,0,0,0,0,0,27.46,68.1454545454545,NA
"2005-W35",1.96633663366337,2.84752475247525,3.54257425742574,2005-08-31,0,0,0,0,0,0,0,0,0,0,0,27.4196428571429,70.9821428571429,NA
"2005-W36",NA,NA,NA,NA,0,0,0,0,0,0,0,0,0,0,0,26.1764705882353,62.7058823529412,NA
"2005-W37",NA,NA,NA,NA,0,0,0,0,0,0,0,0,0,0,0,26.1160714285714,65.4107142857143,NA
"2005-W38",NA,NA,NA,NA,1,0,1,1,0,1,0,1,1,0,0,26.6339285714286,65.875,"2005-09-18 UTC--2005-09-24 UTC"
"2005-W39",1.95686274509804,2.7843137254902,3.47254901960784,2005-09-29,0,0,0,0,0,0,0,0,0,0,0,25.3625,59.8928571428571,NA
"2005-W40",NA,NA,NA,NA,0,0,0,0,0,0,0,0,0,0,0,24.3625,64.3928571428571,NA
"2005-W41",NA,NA,NA,NA,0,0,0,0,0,0,0,0,0,0,0,23.8714285714286,65.9821428571429,NA
"2005-W42",NA,NA,NA,NA,1,0,1,1,0,3,0,3,3,0,0,20.6410714285714,58.0357142857143,"2005-10-16 UTC--2005-10-22 UTC"
"2005-W43",NA,NA,NA,NA,1,1,0,1,0,7,7,0,7,0,0,21.2035714285714,56.4821428571429,"2005-10-23 UTC--2005-10-29 UTC"
"2005-W44",1.94757281553398,2.70097087378641,3.56893203883495,2005-10-31,1,0,1,0,1,1,0,1,0,1,0,17.8053571428571,66.75,"2005-10-30 UTC--2005-11-05 UTC"
"2005-W45",NA,NA,NA,NA,0,0,0,0,0,0,0,0,0,0,0,17.2053571428571,65.125,NA
"2005-W46",NA,NA,NA,NA,0,0,0,0,0,0,0,0,0,0,0,17.0785714285714,69.2142857142857,NA
"2005-W47",NA,NA,NA,NA,0,0,0,0,0,0,0,0,0,0,0,17.1410714285714,68.7678571428571,NA
"2005-W48",NA,NA,NA,NA,0,0,0,0,0,0,0,0,0,0,0,18.6660714285714,70.5178571428571,NA
"2005-W49",NA,NA,NA,NA,2,1,1,1,1,6,5,1,5,1,0,17.5446428571429,79.0892857142857,"2005-12-04 UTC--2005-12-10 UTC"
"2005-W50",NA,NA,NA,NA,1,0,1,1,0,1,0,1,1,0,0,16.3821428571429,77.1785714285714,"2005-12-11 UTC--2005-12-17 UTC"
"2005-W51",NA,NA,NA,NA,0,0,0,0,0,0,0,0,0,0,0,13.1857142857143,79.7142857142857,NA
"2005-W52",1.93873517786561,2.72924901185771,3.29644268774704,2005-12-28,1,0,1,1,0,1,0,1,1,0,0,12.6410714285714,65.9642857142857,"2005-12-25 UTC--2005-12-31 UTC"
"2006-W01",NA,NA,NA,NA,0,0,0,0,0,0,0,0,0,0,0,16.2285714285714,61.1428571428571,NA
"2006-W02",NA,NA,NA,NA,0,0,0,0,0,0,0,0,0,0,0,11.3196428571429,86.8035714285714,NA
"2006-W03",NA,NA,NA,NA,0,0,0,0,0,0,0,0,0,0,0,11.2767857142857,77.9107142857143,NA
"2006-W04",NA,NA,NA,NA,0,0,0,0,0,0,0,0,0,0,0,13.4125,72.625,NA
"2006-W05",NA,2.82156862745098,3.42156862745098,2006-01-31,0,0,0,0,0,0,0,0,0,0,0,13.3125,72.1964285714286,NA
"2006-W06",NA,NA,NA,NA,1,1,0,1,0,1,1,0,1,0,0,13.3142857142857,72.5892857142857,"2006-02-05 UTC--2006-02-11 UTC"
"2006-W07",NA,NA,NA,NA,0,0,0,0,0,0,0,0,0,0,0,12.7178571428571,72.0178571428571,NA
"2006-W08",NA,NA,NA,NA,0,0,0,0,0,0,0,0,0,0,0,16.3875,61.875,NA
"2006-W09",2.1497005988024,2.87425149700599,3.55089820359281,2006-02-28,1,0,1,1,0,1,0,1,1,0,0,15.3767857142857,73.5178571428571,"2006-02-26 UTC--2006-03-04 UTC"
"2006-W10",NA,NA,NA,NA,0,0,0,0,0,0,0,0,0,0,0,15.0410714285714,65.2142857142857,NA
"2006-W11",NA,NA,NA,NA,0,0,0,0,0,0,0,0,0,0,0,15.3767857142857,65.0535714285714,NA
"2006-W12",NA,NA,NA,NA,0,0,0,0,0,0,0,0,0,0,0,17.5910714285714,63.5892857142857,NA
"2006-W13",2.00393700787402,2.71259842519685,3.48425196850394,2006-03-31,1,0,1,1,0,4,0,4,4,0,0,16.2464285714286,69.4107142857143,"2006-03-26 UTC--2006-04-01 UTC"
"2006-W14",NA,NA,NA,NA,0,0,0,0,0,0,0,0,0,0,0,16.6089285714286,75.2142857142857,NA
"2006-W15",NA,NA,NA,NA,0,0,0,0,0,0,0,0,0,0,0,18.7607142857143,70.0178571428571,NA
"2006-W16",NA,NA,NA,NA,1,1,0,1,0,7,7,0,7,0,0,19.0196428571429,72.75,"2006-04-16 UTC--2006-04-22 UTC"
"2006-W17",NA,NA,NA,NA,0,0,0,0,0,0,0,0,0,0,0,20,65.4464285714286,NA
"2006-W18",2.09163346613546,2.91434262948207,3.5996015936255,2006-04-30,0,0,0,0,0,0,0,0,0,0,0,19.6446428571429,69.2857142857143,NA
"2006-W19",NA,NA,NA,NA,0,0,0,0,0,0,0,0,0,0,0,20.5375,64.9642857142857,NA
"2006-W20",NA,NA,NA,NA,0,0,0,0,0,0,0,0,0,0,0,20.5303571428571,69.0178571428571,NA
"2006-W21",NA,NA,NA,NA,0,0,0,0,0,0,0,0,0,0,0,22.9428571428571,70.0714285714286,NA
"2006-W22",2.13948919449902,2.82514734774067,3.70137524557957,2006-05-31,0,0,0,0,0,0,0,0,0,0,0,23.9767857142857,74.2142857142857,NA
"2006-W23",NA,NA,NA,NA,0,0,0,0,0,0,0,0,0,0,0,24.9553571428571,66.875,NA
"2006-W24",NA,NA,NA,NA,0,0,0,0,0,0,0,0,0,0,0,23.8767857142857,63.8392857142857,NA
"2006-W25",NA,NA,NA,NA,0,0,0,0,0,0,0,0,0,0,0,24.9625,70.7857142857143,NA
"2006-W26",2.26377952755906,3.1003937007874,3.81692913385827,2006-06-30,2,1,1,1,1,3,2,1,1,2,0,26.2642857142857,71.8928571428571,"2006-06-25 UTC--2006-07-01 UTC"
"2006-W27",NA,NA,NA,NA,0,0,0,0,0,0,0,0,0,0,0,26.7017857142857,68.8571428571429,NA
"2006-W28",NA,NA,NA,NA,0,0,0,0,0,0,0,0,0,0,0,26.6875,65.3035714285714,NA
"2006-W29",NA,NA,NA,NA,1,0,1,0,1,1,0,1,0,1,0,26.5696428571429,70.0357142857143,"2006-07-16 UTC--2006-07-22 UTC"
"2006-W30",NA,NA,NA,NA,1,0,1,1,0,1,0,1,1,0,0,26.8107142857143,70.4107142857143,"2006-07-23 UTC--2006-07-29 UTC"
"2006-W31",2.33462282398453,NA,NA,2006-07-31,0,0,0,0,0,0,0,0,0,0,0,26.7160714285714,71.0714285714286,NA
"2006-W32",NA,NA,NA,NA,0,0,0,0,0,0,0,0,0,0,0,27.1,68.2727272727273,NA
"2006-W33",NA,NA,NA,NA,1,0,1,0,1,1,0,1,0,1,0,27.4785714285714,67.6785714285714,"2006-08-13 UTC--2006-08-19 UTC"
"2006-W34",NA,NA,NA,NA,0,0,0,0,0,0,0,0,0,0,0,28.3625,72.5178571428571,NA
"2006-W35",2.24206349206349,NA,NA,2006-08-31,0,0,0,0,0,0,0,0,0,0,0,27.6446428571429,65.1428571428571,NA
"2006-W36",NA,NA,NA,NA,0,0,0,0,0,0,0,0,0,0,0,26.45,64.1428571428571,NA
"2006-W37",NA,NA,NA,NA,1,0,1,0,1,1,0,1,0,1,0,27.0125,70.375,"2006-09-10 UTC--2006-09-16 UTC"
"2006-W38",NA,NA,NA,NA,0,0,0,0,0,0,0,0,0,0,0,26.6285714285714,64.125,NA
"2006-W39",2.2647619047619,2.87428571428571,3.81333333333333,2006-09-26,0,0,0,0,0,0,0,0,0,0,0,25.7910714285714,58.6964285714286,NA
"2006-W40",NA,NA,NA,NA,0,0,0,0,0,0,0,0,0,0,0,24.775,67.4285714285714,NA
"2006-W41",NA,NA,NA,NA,0,0,0,0,0,0,0,0,0,0,0,24.9267857142857,57.375,NA
"2006-W42",NA,NA,NA,NA,0,0,0,0,0,0,0,0,0,0,0,22.7375,65.4464285714286,NA
"2006-W43",NA,NA,NA,NA,0,0,0,0,0,0,0,0,0,0,0,21.0696428571429,73.125,NA
"2006-W44",NA,2.94939271255061,3.59109311740891,2006-10-31,1,0,1,0,1,1,0,1,0,1,0,20.3464285714286,68.25,"2006-10-29 UTC--2006-11-04 UTC"
"2006-W45",NA,NA,NA,NA,0,0,0,0,0,0,0,0,0,0,0,16.5017857142857,65.375,NA
"2006-W46",NA,NA,NA,NA,1,1,0,1,0,1,1,0,1,0,0,17.2482142857143,76.6607142857143,"2006-11-12 UTC--2006-11-18 UTC"
"2006-W47",NA,NA,NA,NA,1,1,0,1,0,1,1,0,1,0,0,16.5392857142857,64.5535714285714,"2006-11-19 UTC--2006-11-25 UTC"
"2006-W48",1.9723865877712,2.75739644970414,3.68047337278106,2006-11-30,0,0,0,0,0,0,0,0,0,0,0,14.9035714285714,54.4821428571429,NA
"2006-W49",NA,NA,NA,NA,0,0,0,0,0,0,0,0,0,0,0,14.65,53.8571428571429,NA
"2006-W50",NA,NA,NA,NA,0,0,0,0,0,0,0,0,0,0,0,14.1964285714286,60.2678571428571,NA
"2006-W51",NA,NA,NA,NA,0,0,0,0,0,0,0,0,0,0,0,12.8018181818182,65.9636363636364,NA
"2006-W52",2.00204918032787,2.90163934426229,3.66803278688525,2006-12-30,0,0,0,0,0,0,0,0,0,0,0,10.2160714285714,75.25,NA
"2006-W53",NA,NA,NA,NA,0,0,0,0,0,0,0,0,0,0,0,10.5,88.25,NA
"2007-W00",NA,NA,NA,NA,0,0,0,0,0,0,0,0,0,0,0,11.4208333333333,79.125,NA
"2007-W01",NA,NA,NA,NA,0,0,0,0,0,0,0,0,0,0,0,12.1910714285714,69.3035714285714,NA
"2007-W02",NA,NA,NA,NA,0,0,0,0,0,0,0,0,0,0,0,11.3642857142857,74.625,NA
"2007-W03",NA,NA,NA,NA,0,0,0,0,0,0,0,0,0,0,0,12.7660714285714,72.5357142857143,NA
"2007-W04",2.09941520467836,2.74658869395711,3.57699805068226,2007-01-31,1,1,0,1,0,3,3,0,3,0,0,12.9982142857143,72.1607142857143,"2007-01-28 UTC--2007-02-03 UTC"
"2007-W05",NA,NA,NA,NA,0,0,0,0,0,0,0,0,0,0,0,12.1928571428571,77.6964285714286,NA
"2007-W06",NA,NA,NA,NA,0,0,0,0,0,0,0,0,0,0,0,14.0857142857143,75.6428571428571,NA
"2007-W07",NA,NA,NA,NA,0,0,0,0,0,0,0,0,0,0,0,14.975,70.625,NA
"2007-W08",2.15079365079365,2.63492063492063,3.64285714285714,2007-02-28,1,0,1,1,0,1,0,1,1,0,0,14.6839285714286,75.4107142857143,"2007-02-25 UTC--2007-03-03 UTC"
"2007-W09",NA,NA,NA,NA,0,0,0,0,0,0,0,0,0,0,0,15.175,69.0714285714286,NA
"2007-W10",NA,NA,NA,NA,0,0,0,0,0,0,0,0,0,0,0,14.5160714285714,74.6071428571429,NA
"2007-W11",NA,NA,NA,NA,0,0,0,0,0,0,0,0,0,0,0,16.6607142857143,65.4107142857143,NA
"2007-W12",1.98823529411765,2.52156862745098,3.47450980392157,2007-03-28,0,0,0,0,0,0,0,0,0,0,0,15.15,69.3214285714286,NA
"2007-W13",NA,NA,NA,NA,0,0,0,0,0,0,0,0,0,0,0,18.6464285714286,64.7678571428571,NA
"2007-W14",NA,NA,NA,NA,0,0,0,0,0,0,0,0,0,0,0,17.0089285714286,71.4642857142857,NA
"2007-W15",NA,NA,NA,NA,0,0,0,0,0,0,0,0,0,0,0,17.8321428571429,63.2321428571429,NA
"2007-W16",NA,NA,NA,NA,0,0,0,0,0,0,0,0,0,0,0,20.2178571428571,59.3214285714286,NA
"2007-W17",2.12407407407407,2.66851851851852,3.56296296296296,2007-04-30,0,0,0,0,0,0,0,0,0,0,0,21.2803571428571,60.375,NA
"2007-W18",NA,NA,NA,NA,0,0,0,0,0,0,0,0,0,0,0,24.1357142857143,63.6785714285714,NA
"2007-W19",NA,NA,NA,NA,0,0,0,0,0,0,0,0,0,0,0,21.4928571428571,71.0892857142857,NA
"2007-W20",NA,NA,NA,NA,1,1,0,1,0,1,1,0,1,0,0,22.1388888888889,66.1666666666667,"2007-05-20 UTC--2007-05-26 UTC"
"2007-W21",2.2421875,2.859375,3.7578125,2007-05-31,1,1,0,1,0,1,1,0,1,0,0,23.8732142857143,62.75,"2007-05-27 UTC--2007-06-02 UTC"
"2007-W22",NA,NA,NA,NA,0,0,0,0,0,0,0,0,0,0,0,23.4446428571429,67.1964285714286,NA
"2007-W23",NA,NA,NA,NA,0,0,0,0,0,0,0,0,0,0,0,24.7785714285714,66.3392857142857,NA
"2007-W24",NA,NA,NA,NA,0,0,0,0,0,0,0,0,0,0,0,25.4696428571429,70.3035714285714,NA
"2007-W25",2.10079051383399,2.85770750988142,3.68181818181818,2007-06-30,0,0,0,0,0,0,0,0,0,0,0,27.8089285714286,64.3928571428571,NA
"2007-W26",NA,NA,NA,NA,0,0,0,0,0,0,0,0,0,0,0,25.9982142857143,68.3928571428571,NA
"2007-W27",NA,NA,NA,NA,1,0,1,0,1,1,0,1,0,1,0,26.5910714285714,67.3035714285714,"2007-07-08 UTC--2007-07-14 UTC"
"2007-W28",NA,NA,NA,NA,0,0,0,0,0,0,0,0,0,0,0,27.2767857142857,67.6964285714286,NA
"2007-W29",NA,NA,NA,NA,0,0,0,0,0,0,0,0,0,0,0,28.5053571428571,68.3214285714286,NA
"2007-W30",2.15717092337917,2.96070726915521,3.68369351669941,2007-07-31,0,0,0,0,0,0,0,0,0,0,0,28.5964285714286,68.25,NA
"2007-W31",NA,NA,NA,NA,0,0,0,0,0,0,0,0,0,0,0,27.4214285714286,61.1071428571429,NA
"2007-W32",NA,NA,NA,NA,0,0,0,0,0,0,0,0,0,0,0,27.2357142857143,67.25,NA
"2007-W33",NA,NA,NA,NA,0,0,0,0,0,0,0,0,0,0,0,27.8267857142857,71.0357142857143,NA
"2007-W34",2.21626984126984,3.12103174603175,3.95436507936508,2007-08-31,0,0,0,0,0,0,0,0,0,0,0,28.0946428571429,70.3035714285714,NA
"2007-W35",NA,NA,NA,NA,0,0,0,0,0,0,0,0,0,0,0,28.1053571428571,67.0892857142857,NA
"2007-W36",NA,NA,NA,NA,0,0,0,0,0,0,0,0,0,0,0,25.7232142857143,61.4285714285714,NA
"2007-W37",NA,NA,NA,NA,1,0,1,0,1,1,0,1,0,1,0,25.6125,67.75,"2007-09-16 UTC--2007-09-22 UTC"
"2007-W38",NA,NA,NA,NA,0,0,0,0,0,0,0,0,0,0,0,25.9821428571429,65.8928571428571,NA
"2007-W39",2.02642276422764,3,3.77845528455285,2007-09-30,0,0,0,0,0,0,0,0,0,0,0,25.5107142857143,70,NA
"2007-W40",NA,NA,NA,NA,0,0,0,0,0,0,0,0,0,0,0,24.7125,70.5535714285714,NA
"2007-W41",NA,NA,NA,NA,1,0,1,0,1,1,0,1,0,1,0,24.1482142857143,60.75,"2007-10-14 UTC--2007-10-20 UTC"
"2007-W42",NA,NA,NA,NA,0,0,0,0,0,0,0,0,0,0,0,23.3910714285714,69.6964285714286,NA
"2007-W43",2.09181636726547,2.64870259481038,3.46506986027944,2007-10-31,1,0,1,0,1,1,0,1,0,1,0,21.9928571428571,70.8571428571429,"2007-10-28 UTC--2007-11-03 UTC"
"2007-W44",NA,NA,NA,NA,0,0,0,0,0,0,0,0,0,0,0,22.0428571428571,55.3035714285714,NA
"2007-W45",NA,NA,NA,NA,0,0,0,0,0,0,0,0,0,0,0,18.8464285714286,66.6964285714286,NA
"2007-W46",NA,NA,NA,NA,1,0,1,1,0,1,0,1,1,0,0,16.5875,77.8928571428571,"2007-11-18 UTC--2007-11-24 UTC"
"2007-W47",2.04,2.756,3.534,2007-11-30,0,0,0,0,0,0,0,0,0,0,0,16.4053571428571,67.9285714285714,NA
"2007-W48",NA,NA,NA,NA,0,0,0,0,0,0,0,0,0,0,0,16.2678571428571,76.25,NA
"2007-W49",NA,NA,NA,NA,0,0,0,0,0,0,0,0,0,0,0,15.1964285714286,70.3928571428571,NA
"2007-W50",NA,NA,NA,NA,0,0,0,0,0,0,0,0,0,0,0,13.6875,77.0714285714286,NA
"2007-W51",NA,NA,NA,NA,1,0,1,1,0,2,0,2,2,0,0,12.8178571428571,65.9821428571429,"2007-12-23 UTC--2007-12-29 UTC"
"2007-W52",2.01587301587302,2.81150793650794,3.50793650793651,2007-12-31,0,0,0,0,0,0,0,0,0,0,0,10.3125,59.375,NA
"2008-W00",NA,NA,NA,NA,0,0,0,0,0,0,0,0,0,0,0,13.55,73.9,NA
"2008-W01",NA,NA,NA,NA,0,0,0,0,0,0,0,0,0,0,0,10.8732142857143,74.6607142857143,NA
"2008-W02",NA,NA,NA,NA,0,0,0,0,0,0,0,0,0,0,0,8.48928571428571,50.4285714285714,NA
"2008-W03",NA,NA,NA,NA,1,0,1,0,1,1,0,1,0,1,0,11.1875,74.6071428571429,"2008-01-20 UTC--2008-01-26 UTC"
"2008-W04",2.2990099009901,2.94257425742574,3.69108910891089,2008-01-31,0,0,0,0,0,0,0,0,0,0,0,11.1763636363636,74.2909090909091,NA
"2008-W05",NA,NA,NA,NA,1,1,0,1,0,1,1,0,1,0,0,12.6446428571429,67.4107142857143,"2008-02-03 UTC--2008-02-09 UTC"
"2008-W06",NA,NA,NA,NA,0,0,0,0,0,0,0,0,0,0,0,12.9089285714286,76.7857142857143,NA
"2008-W07",NA,NA,NA,NA,0,0,0,0,0,0,0,0,0,0,0,11.9839285714286,68.4464285714286,NA
"2008-W08",2.28942115768463,3.03393213572854,3.75449101796407,2008-02-29,2,1,1,1,1,3,1,2,1,2,0,14.3339285714286,76.3214285714286,"2008-02-24 UTC--2008-03-01 UTC"
"2008-W09",NA,NA,NA,NA,2,1,1,1,1,10,8,2,8,2,0,17.5571428571429,68.125,"2008-03-02 UTC--2008-03-08 UTC"
"2008-W10",NA,NA,NA,NA,0,0,0,0,0,0,0,0,0,0,0,16.6553571428571,68.9107142857143,NA
"2008-W11",NA,NA,NA,NA,0,0,0,0,0,0,0,0,0,0,0,18.4982142857143,54.4821428571429,NA
"2008-W12",NA,NA,NA,NA,0,0,0,0,0,0,0,0,0,0,0,20.7660714285714,48.5714285714286,NA
"2008-W13",2.10685483870968,NA,NA,2008-03-31,0,0,0,0,0,0,0,0,0,0,0,17.0321428571429,66.0357142857143,NA
"2008-W14",NA,NA,NA,NA,2,1,1,1,1,3,2,1,2,1,0,18.7125,63.4642857142857,"2008-04-06 UTC--2008-04-12 UTC"
"2008-W15",NA,NA,NA,NA,1,1,0,0,1,3,3,0,0,3,0,21.5553571428571,55.6607142857143,"2008-04-13 UTC--2008-04-19 UTC"
"2008-W16",NA,NA,NA,NA,1,0,1,1,0,2,0,2,2,0,0,23.0464285714286,55.1964285714286,"2008-04-20 UTC--2008-04-26 UTC"
"2008-W17",2.11698113207547,NA,NA,2008-04-30,0,0,0,0,0,0,0,0,0,0,0,18.4178571428571,63.625,NA
"2008-W18",NA,NA,NA,NA,1,1,0,1,0,1,1,0,1,0,0,19.7535714285714,59.9285714285714,"2008-05-04 UTC--2008-05-10 UTC"
"2008-W19",NA,NA,NA,NA,1,1,0,1,0,1,1,0,1,0,0,21.7339285714286,58.1607142857143,"2008-05-11 UTC--2008-05-17 UTC"
"2008-W20",NA,NA,NA,NA,0,0,0,0,0,0,0,0,0,0,0,21.8642857142857,70.8392857142857,NA
"2008-W21",2.06311637080868,NA,0.00394477317554241,2008-05-31,0,0,0,0,0,0,0,0,0,0,0,22.5696428571429,69.8035714285714,NA
"2008-W22",NA,NA,NA,NA,1,1,0,1,0,1,1,0,1,0,0,24.6428571428571,63.8571428571429,"2008-06-01 UTC--2008-06-07 UTC"
"2008-W23",NA,NA,NA,NA,0,0,0,0,0,0,0,0,0,0,0,25.0428571428571,60.2857142857143,NA
"2008-W24",NA,NA,NA,NA,0,0,0,0,0,0,0,0,0,0,0,25.2392857142857,64.75,NA
"2008-W25",NA,NA,NA,NA,0,0,0,0,0,0,0,0,0,0,0,26.4857142857143,69.7142857142857,NA
"2008-W26",2.18687872763419,2.83300198807157,3.66600397614314,2008-06-30,1,1,0,1,0,2,2,0,2,0,0,26.8410714285714,70.2678571428571,"2008-06-29 UTC--2008-07-05 UTC"
"2008-W27",NA,NA,NA,NA,1,0,1,0,1,1,0,1,0,1,0,26.9607142857143,66.2321428571429,"2008-07-06 UTC--2008-07-12 UTC"
"2008-W28",NA,NA,NA,NA,0,0,0,0,0,0,0,0,0,0,0,27.3303571428571,68.125,NA
"2008-W29",NA,NA,NA,NA,0,0,0,0,0,0,0,0,0,0,0,27.4553571428571,65.1785714285714,NA
"2008-W30",2.17623762376238,NA,NA,2008-07-31,0,0,0,0,0,0,0,0,0,0,0,27.3017857142857,65.4107142857143,NA
"2008-W31",NA,NA,NA,NA,0,0,0,0,0,0,0,0,0,0,0,27.2,67.1071428571429,NA
"2008-W32",NA,NA,NA,NA,0,0,0,0,0,0,0,0,0,0,0,27.2732142857143,67.4821428571429,NA
"2008-W33",NA,NA,NA,NA,0,0,0,0,0,0,0,0,0,0,0,28.0125,70.4821428571429,NA
"2008-W34",NA,NA,NA,NA,0,0,0,0,0,0,0,0,0,0,0,28.3178571428571,71.9107142857143,NA
"2008-W35",2.19094488188976,NA,NA,2008-08-31,0,0,0,0,0,0,0,0,0,0,0,27.9785714285714,66.8928571428571,NA
"2008-W36",NA,NA,NA,NA,0,0,0,0,0,0,0,0,0,0,0,26.5303571428571,66.1964285714286,NA
"2008-W37",NA,NA,NA,NA,0,0,0,0,0,0,0,0,0,0,0,26.4321428571429,66.5714285714286,NA
"2008-W38",NA,NA,NA,NA,0,0,0,0,0,0,0,0,0,0,0,26.2892857142857,55.9821428571429,NA
"2008-W39",2.07370517928287,NA,NA,2008-09-30,0,0,0,0,0,0,0,0,0,0,0,24.6607142857143,57.1071428571429,NA
"2008-W40",NA,NA,NA,NA,0,0,0,0,0,0,0,0,0,0,0,23.9517857142857,62.8214285714286,NA
"2008-W41",NA,NA,NA,NA,0,0,0,0,0,0,0,0,0,0,0,23.2642857142857,67.5,NA
"2008-W42",NA,NA,NA,NA,1,0,1,1,0,1,0,1,1,0,0,22.9660714285714,69.3392857142857,"2008-10-19 UTC--2008-10-25 UTC"
"2008-W43",2.19721115537849,NA,NA,2008-10-31,0,0,0,0,0,0,0,0,0,0,0,19.375,79.6071428571429,NA
"2008-W44",NA,NA,NA,NA,0,0,0,0,0,0,0,0,0,0,0,20.4892857142857,51.8214285714286,NA
"2008-W45",NA,NA,NA,NA,0,0,0,0,0,0,0,0,0,0,0,19.2160714285714,70.8571428571429,NA
"2008-W46",NA,NA,NA,NA,0,0,0,0,0,0,0,0,0,0,0,18.6285714285714,67.8571428571429,NA
"2008-W47",NA,NA,NA,NA,0,0,0,0,0,0,0,0,0,0,0,17.4553571428571,66.3571428571429,NA
"2008-W48",2.032,NA,NA,2008-11-30,0,0,0,0,0,0,0,0,0,0,0,16.7017857142857,45.3392857142857,NA
"2008-W49",NA,NA,NA,NA,0,0,0,0,0,0,0,0,0,0,0,16.5571428571429,61.4464285714286,NA
"2008-W50",NA,NA,NA,NA,0,0,0,0,0,0,0,0,0,0,0,15.3017857142857,61.3214285714286,NA
"2008-W51",NA,NA,NA,NA,0,0,0,0,0,0,0,0,0,0,0,14.3392857142857,71.0892857142857,NA
"2008-W52",2.24453280318091,NA,NA,2008-12-31,0,0,0,0,0,0,0,0,0,0,0,13.634375,75.40625,NA
"2009-W00",NA,NA,NA,NA,0,0,0,0,0,0,0,0,0,0,0,10.4,64.1666666666667,NA
"2009-W01",NA,NA,NA,NA,0,0,0,0,0,0,0,0,0,0,0,12.8446428571429,72.8928571428571,NA
"2009-W02",NA,NA,NA,NA,0,0,0,0,0,0,0,0,0,0,0,12.5589285714286,53.2142857142857,NA
"2009-W03",NA,NA,NA,NA,0,0,0,0,0,0,0,0,0,0,0,15.0017857142857,64.875,NA
"2009-W04",2.03346456692913,NA,NA,2009-01-31,1,0,1,0,1,1,0,1,0,1,0,14.6428571428571,60.1428571428571,"2009-01-25 UTC--2009-01-31 UTC"
"2009-W05",NA,NA,NA,NA,0,0,0,0,0,0,0,0,0,0,0,14.8017857142857,68.625,NA
"2009-W06",NA,NA,NA,NA,0,0,0,0,0,0,0,0,0,0,0,15.2053571428571,67.375,NA
"2009-W07",NA,NA,NA,NA,0,0,0,0,0,0,0,0,0,0,0,13.9946428571429,67.2142857142857,NA
"2009-W08",NA,NA,NA,NA,0,0,0,0,0,0,0,0,0,0,0,12.7821428571429,70.6607142857143,NA
"2009-W09",NA,NA,NA,NA,0,0,0,0,0,0,0,0,0,0,0,16.4732142857143,64.1607142857143,NA
"2009-W10",NA,NA,NA,NA,0,0,0,0,0,0,0,0,0,0,0,15.9,68.9285714285714,NA
"2009-W11",NA,NA,NA,NA,0,0,0,0,0,0,0,0,0,0,0,14.1553571428571,63.5714285714286,NA
"2009-W12",NA,NA,NA,NA,0,0,0,0,0,0,0,0,0,0,0,14.8196428571429,64.1785714285714,NA
"2009-W13",2.03762376237624,NA,NA,2009-03-31,1,0,1,1,0,1,0,1,1,0,0,16.5482142857143,71,"2009-03-29 UTC--2009-04-04 UTC"
"2009-W14",NA,NA,NA,NA,0,0,0,0,0,0,0,0,0,0,0,17.8178571428571,67.0535714285714,NA
"2009-W15",NA,NA,NA,NA,0,0,0,0,0,0,0,0,0,0,0,19.7678571428571,59.1428571428571,NA
"2009-W16",NA,NA,NA,NA,0,0,0,0,0,0,0,0,0,0,0,19.5018181818182,57.5090909090909,NA
"2009-W17",1.98823529411765,NA,NA,2009-04-30,0,0,0,0,0,0,0,0,0,0,0,18.6017857142857,65.0714285714286,NA
"2009-W18",NA,NA,NA,NA,0,0,0,0,0,0,0,0,0,0,0,20.825,58.4107142857143,NA
"2009-W19",NA,NA,NA,NA,1,1,0,1,0,1,1,0,1,0,0,20.9785714285714,66.0892857142857,"2009-05-10 UTC--2009-05-16 UTC"
"2009-W20",NA,NA,NA,NA,0,0,0,0,0,0,0,0,0,0,0,24.0214285714286,56.5714285714286,NA
"2009-W21",NA,NA,NA,NA,0,0,0,0,0,0,0,0,0,0,0,22.5964285714286,65.625,NA
"2009-W22",1.94252873563218,NA,NA,2009-05-31,0,0,0,0,0,0,0,0,0,0,0,23.8357142857143,66.0892857142857,NA
"2009-W23",NA,NA,NA,NA,0,0,0,0,0,0,0,0,0,0,0,24.9589285714286,67.75,NA
"2009-W24",NA,NA,NA,NA,0,0,0,0,0,0,0,0,0,0,0,25.5982142857143,67.4642857142857,NA
"2009-W25",NA,NA,NA,NA,0,0,0,0,0,0,0,0,0,0,0,26.7339285714286,66.8035714285714,NA
"2009-W26",1.95127610208817,NA,NA,2009-06-30,0,0,0,0,0,0,0,0,0,0,0,27.2410714285714,59.7142857142857,NA
"2009-W27",NA,NA,NA,NA,0,0,0,0,0,0,0,0,0,0,0,27.2339285714286,66.375,NA
"2009-W28",NA,NA,NA,NA,0,0,0,0,0,0,0,0,0,0,0,27.5464285714286,61.75,NA
"2009-W29",NA,NA,NA,NA,0,0,0,0,0,0,0,0,0,0,0,28.0875,69.1071428571429,NA
"2009-W30",1.94431554524362,NA,NA,2009-07-31,0,0,0,0,0,0,0,0,0,0,0,28.175,66.75,NA
"2009-W31",NA,NA,NA,NA,0,0,0,0,0,0,0,0,0,0,0,28.1678571428571,65.0357142857143,NA
"2009-W32",NA,NA,NA,NA,0,0,0,0,0,0,0,0,0,0,0,28.2142857142857,63.8571428571429,NA
"2009-W33",NA,NA,NA,NA,0,0,0,0,0,0,0,0,0,0,0,28.6982142857143,68.9642857142857,NA
"2009-W34",NA,NA,NA,NA,0,0,0,0,0,0,0,0,0,0,0,27.5267857142857,63.25,NA
"2009-W35",1.89569160997732,NA,NA,2009-08-31,0,0,0,0,0,0,0,0,0,0,0,27.3053571428571,64.1071428571429,NA
"2009-W36",NA,NA,NA,NA,0,0,0,0,0,0,0,0,0,0,0,27.3767857142857,61.6071428571429,NA
"2009-W37",NA,NA,NA,NA,0,0,0,0,0,0,0,0,0,0,0,27.1910714285714,66.4107142857143,NA
"2009-W38",NA,NA,NA,NA,0,0,0,0,0,0,0,0,0,0,0,25.2767857142857,62.6607142857143,NA
"2009-W39",1.87990762124711,NA,NA,2009-09-30,0,0,0,0,0,0,0,0,0,0,0,25.1517857142857,66.1071428571429,NA
"2009-W40",NA,NA,NA,NA,0,0,0,0,0,0,0,0,0,0,0,24.8196428571429,73.4285714285714,NA
"2009-W41",NA,NA,NA,NA,0,0,0,0,0,0,0,0,0,0,0,24.9035714285714,66.9464285714286,NA
"2009-W42",NA,NA,NA,NA,0,0,0,0,0,0,0,0,0,0,0,25.5553571428571,53.8035714285714,NA
"2009-W43",1.90232558139535,NA,NA,2009-10-31,0,0,0,0,0,0,0,0,0,0,0,23.3053571428571,66.25,NA
"2009-W44",NA,NA,NA,NA,0,0,0,0,0,0,0,0,0,0,0,20.2607142857143,63.9464285714286,NA
"2009-W45",NA,NA,NA,NA,0,0,0,0,0,0,0,0,0,0,0,20.6178571428571,70.9642857142857,NA
"2009-W46",NA,NA,NA,NA,0,0,0,0,0,0,0,0,0,0,0,17.1839285714286,70.3928571428571,NA
"2009-W47",NA,NA,NA,NA,0,0,0,0,0,0,0,0,0,0,0,16.8946428571429,69.5714285714286,NA
"2009-W48",1.94700460829493,NA,NA,2009-11-30,0,0,0,0,0,0,0,0,0,0,0,17.0821428571429,65.7678571428571,NA
"2009-W49",NA,NA,NA,NA,0,0,0,0,0,0,0,0,0,0,0,15.9875,73.3392857142857,NA
"2009-W50",NA,NA,NA,NA,0,0,0,0,0,0,0,0,0,0,0,15.5107142857143,68.9285714285714,NA
"2009-W51",NA,NA,NA,NA,1,0,1,1,0,1,0,1,1,0,0,15.6803571428571,78.8392857142857,"2009-12-20 UTC--2009-12-26 UTC"
"2009-W52",1.82618510158014,NA,NA,2009-12-31,0,0,0,0,0,0,0,0,0,0,0,16.1175,81.325,NA
"2010-W00",NA,NA,NA,NA,0,0,0,0,0,0,0,0,0,0,0,16.16875,81.375,NA
"2010-W01",NA,NA,NA,NA,0,0,0,0,0,0,0,0,0,0,0,15.8875,76.1785714285714,NA
"2010-W02",NA,NA,NA,NA,0,0,0,0,0,0,0,0,0,0,0,15.2053571428571,75.6964285714286,NA
"2010-W03",NA,NA,NA,NA,0,0,0,0,0,0,0,0,0,0,0,14.7803571428571,79.8035714285714,NA
"2010-W04",NA,NA,NA,NA,0,0,0,0,0,0,0,0,0,0,0,14.3089285714286,65.5178571428571,NA
"2010-W05",1.85011709601874,NA,NA,2010-01-31,0,0,0,0,0,0,0,0,0,0,0,12.7214285714286,73.7857142857143,NA
"2010-W06",NA,NA,NA,NA,1,0,1,0,1,1,0,1,0,1,0,15.5125,63.25,"2010-02-07 UTC--2010-02-13 UTC"
"2010-W07",NA,NA,NA,NA,0,0,0,0,0,0,0,0,0,0,0,20.2785714285714,64.0892857142857,NA
"2010-W08",NA,NA,NA,NA,1,1,0,1,0,1,1,0,1,0,0,16.2625,74.0892857142857,"2010-02-21 UTC--2010-02-27 UTC"
"2010-W09",1.69739952718676,NA,NA,2010-02-28,0,0,0,0,0,0,0,0,0,0,0,17.1071428571429,77.5892857142857,NA
"2010-W10",NA,NA,NA,NA,0,0,0,0,0,0,0,0,0,0,0,21.5017857142857,68.9642857142857,NA
"2010-W11",NA,NA,NA,NA,0,0,0,0,0,0,0,0,0,0,0,17.5928571428571,60.9285714285714,NA
"2010-W12",NA,NA,NA,NA,1,0,1,0,1,2,0,2,0,2,0,17.8107142857143,58.8928571428571,"2010-03-21 UTC--2010-03-27 UTC"
"2010-W13",NA,NA,NA,NA,0,0,0,0,0,0,0,0,0,0,0,17.5392857142857,61.75,NA
"2010-W14",NA,NA,NA,NA,0,0,0,0,0,0,0,0,0,0,0,18.0678571428571,66.9821428571429,NA
"2010-W15",NA,NA,NA,NA,0,0,0,0,0,0,0,0,0,0,0,19.0839285714286,64.8214285714286,NA
"2010-W16",NA,NA,NA,NA,0,0,0,0,0,0,0,0,0,0,0,20.3125,60.625,NA
"2010-W17",1.68421052631579,NA,NA,2010-04-30,0,0,0,0,0,0,0,0,0,0,0,20.1428571428571,63.7142857142857,NA
"2010-W18",NA,NA,NA,NA,0,0,0,0,0,0,0,0,0,0,0,20.2678571428571,65.9285714285714,NA
"2010-W19",NA,NA,NA,NA,0,0,0,0,0,0,0,0,0,0,0,23.1696428571429,58.6071428571429,NA
"2010-W20",NA,NA,NA,NA,0,0,0,0,0,0,0,0,0,0,0,22.6178571428571,59.1428571428571,NA
"2010-W21",NA,NA,NA,NA,0,0,0,0,0,0,0,0,0,0,0,22.9589285714286,62.75,NA
"2010-W22",2.06420233463035,NA,NA,2010-05-30,0,0,0,0,0,0,0,0,0,0,0,24.5857142857143,66.8214285714286,NA
"2010-W23",1.90606653620352,NA,NA,2010-06-08,0,0,0,0,0,0,0,0,0,0,0,24.85,62.2142857142857,NA
"2010-W24",NA,NA,NA,NA,1,0,1,1,0,1,0,1,1,0,0,25.9267857142857,68.4107142857143,"2010-06-13 UTC--2010-06-19 UTC"
"2010-W25",NA,NA,NA,NA,0,0,0,0,0,0,0,0,0,0,0,27.1196428571429,56.1428571428571,NA
"2010-W26",NA,NA,NA,NA,0,0,0,0,0,0,0,0,0,0,0,25.9125,60.875,NA
"2010-W27",2,NA,NA,2010-07-07,0,0,0,0,0,0,0,0,0,0,0,26.4482142857143,69.1785714285714,NA
"2010-W28",NA,NA,NA,NA,0,0,0,0,0,0,0,0,0,0,0,27.3660714285714,69.1964285714286,NA
"2010-W29",NA,NA,NA,NA,0,0,0,0,0,0,0,0,0,0,0,27.5464285714286,68.1071428571429,NA
"2010-W30",NA,NA,NA,NA,0,0,0,0,0,0,0,0,0,0,0,28.3714285714286,65.8035714285714,NA
"2010-W31",NA,NA,NA,NA,0,0,0,0,0,0,0,0,0,0,0,29.4517857142857,67.0892857142857,NA
"2010-W32",NA,NA,NA,NA,0,0,0,0,0,0,0,0,0,0,0,28.5428571428571,67.2678571428571,NA
"2010-W33",NA,NA,NA,NA,0,0,0,0,0,0,0,0,0,0,0,29.6607142857143,72.3392857142857,NA
"2010-W34",NA,NA,NA,NA,0,0,0,0,0,0,0,0,0,0,0,29.1571428571429,70.5535714285714,NA
"2010-W35",NA,NA,NA,NA,1,0,1,1,0,4,0,4,4,0,0,28.4642857142857,64.8928571428571,"2010-08-29 UTC--2010-09-04 UTC"
"2010-W36",NA,NA,NA,NA,0,0,0,0,0,0,0,0,0,0,0,28.0875,67.2857142857143,NA
"2010-W37",1.8986083499006,NA,NA,2010-09-14,0,0,0,0,0,0,0,0,0,0,0,27.6464285714286,61.5357142857143,NA
"2010-W38",NA,NA,NA,NA,0,0,0,0,0,0,0,0,0,0,0,27.9517857142857,73.1428571428571,NA
"2010-W39",NA,NA,NA,NA,0,0,0,0,0,0,0,0,0,0,0,28.0035714285714,66.6428571428571,NA
"2010-W40",NA,NA,NA,NA,0,0,0,0,0,0,0,0,0,0,0,25.6196428571429,63.2857142857143,NA
"2010-W41",NA,NA,NA,NA,0,0,0,0,0,0,0,0,0,0,0,25.6410714285714,55.4821428571429,NA
"2010-W42",1.91976516634051,NA,NA,2010-10-20,0,0,0,0,0,0,0,0,0,0,0,26.3232142857143,62.5178571428571,NA
"2010-W43",NA,NA,NA,NA,0,0,0,0,0,0,0,0,0,0,0,23.3446428571429,66.8392857142857,NA
"2010-W44",NA,NA,NA,NA,0,0,0,0,0,0,0,0,0,0,0,23.1982142857143,47.4107142857143,NA
"2010-W45",NA,NA,NA,NA,0,0,0,0,0,0,0,0,0,0,0,21.1946428571429,70.625,NA
"2010-W46",1.96274509803922,NA,NA,2010-11-16,0,0,0,0,0,0,0,0,0,0,0,21.7946428571429,78,NA
"2010-W47",NA,NA,NA,NA,0,0,0,0,0,0,0,0,0,0,0,18.9053571428571,70.2857142857143,NA
"2010-W48",NA,NA,NA,NA,0,0,0,0,0,0,0,0,0,0,0,17.9357142857143,48.9107142857143,NA
"2010-W49",NA,NA,NA,NA,0,0,0,0,0,0,0,0,0,0,0,18.0107142857143,65.8928571428571,NA
"2010-W50",1.93542074363992,NA,NA,2010-12-13,0,0,0,0,0,0,0,0,0,0,0,14.4357142857143,65.0892857142857,NA
"2010-W51",NA,NA,NA,NA,0,0,0,0,0,0,0,0,0,0,0,15.4589285714286,70.5178571428571,NA
"2010-W52",NA,NA,NA,NA,0,0,0,0,0,0,0,0,0,0,0,17.6145833333333,45.4791666666667,NA
"2011-W00",NA,NA,NA,NA,0,0,0,0,0,0,0,0,0,0,0,15.9875,77.625,NA
"2011-W01",NA,NA,NA,NA,0,0,0,0,0,0,0,0,0,0,0,14.5642857142857,78.0178571428571,NA
"2011-W02",NA,NA,NA,NA,0,0,0,0,0,0,0,0,0,0,0,14.0875,72.0535714285714,NA
"2011-W03",1.96862745098039,NA,NA,2011-01-19,0,0,0,0,0,0,0,0,0,0,0,13.9232142857143,67.6964285714286,NA
"2011-W04",NA,NA,NA,NA,0,0,0,0,0,0,0,0,0,0,0,15.0410714285714,73.7321428571429,NA
"2011-W05",NA,NA,NA,NA,0,0,0,0,0,0,0,0,0,0,0,14.0678571428571,76.1785714285714,NA
"2011-W06",NA,NA,NA,NA,0,0,0,0,0,0,0,0,0,0,0,14.3428571428571,78.8571428571429,NA
"2011-W07",NA,NA,NA,NA,0,0,0,0,0,0,0,0,0,0,0,15.7928571428571,71.1428571428571,NA
"2011-W08",1.95294117647059,NA,NA,2011-02-22,0,0,0,0,0,0,0,0,0,0,0,16.4892857142857,68.1607142857143,NA
"2011-W09",NA,NA,NA,NA,0,0,0,0,0,0,0,0,0,0,0,15.5125,72.0357142857143,NA
"2011-W10",NA,NA,NA,NA,1,0,1,1,0,5,0,5,5,0,0,14.7625,72.5357142857143,"2011-03-06 UTC--2011-03-12 UTC"
"2011-W11",NA,NA,NA,NA,0,0,0,0,0,0,0,0,0,0,0,16.0732142857143,61.75,NA
"2011-W12",2.14509803921569,NA,NA,2011-03-24,1,1,0,1,0,2,2,0,2,0,0,16.5767857142857,74.2678571428571,"2011-03-20 UTC--2011-03-26 UTC"
"2011-W13",NA,NA,NA,NA,0,0,0,0,0,0,0,0,0,0,0,17.4803571428571,70.625,NA
"2011-W14",NA,NA,NA,NA,1,1,0,1,0,1,1,0,1,0,0,17.1589285714286,75.3392857142857,"2011-04-03 UTC--2011-04-09 UTC"
"2011-W15",NA,NA,NA,NA,0,0,0,0,0,0,0,0,0,0,0,18.7910714285714,59.375,NA
"2011-W16",NA,NA,NA,NA,0,0,0,0,0,0,0,0,0,0,0,20.875,58.4821428571429,NA
"2011-W17",NA,NA,NA,NA,1,0,1,1,0,1,0,1,1,0,0,19.7821428571429,65.3035714285714,"2011-04-24 UTC--2011-04-30 UTC"
"2011-W18",NA,NA,NA,NA,0,0,0,0,0,0,0,0,0,0,0,22.6089285714286,58.3928571428571,NA
"2011-W19",NA,NA,NA,NA,0,0,0,0,0,0,0,0,0,0,0,20.3196428571429,64.625,NA
"2011-W20",NA,NA,NA,NA,0,0,0,0,0,0,0,0,0,0,0,22.2464285714286,65.375,NA
"2011-W21",NA,NA,NA,NA,0,0,0,0,0,0,0,0,0,0,0,24.1428571428571,63.9464285714286,NA
"2011-W22",2.12156862745098,NA,NA,2011-05-30,0,0,0,0,0,0,0,0,0,0,0,23.3071428571429,70.5535714285714,NA
"2011-W23",NA,NA,NA,NA,0,0,0,0,0,0,0,0,0,0,0,25.5214285714286,68.0892857142857,NA
"2011-W24",NA,NA,NA,NA,0,0,0,0,0,0,0,0,0,0,0,25,66.4285714285714,NA
"2011-W25",NA,NA,NA,NA,0,0,0,0,0,0,0,0,0,0,0,26.1857142857143,71.3928571428571,NA
"2011-W26",1.9843137254902,NA,NA,2011-06-28,0,0,0,0,0,0,0,0,0,0,0,25.7017857142857,64.1964285714286,NA
"2011-W27",NA,NA,NA,NA,0,0,0,0,0,0,0,0,0,0,0,26.6053571428571,69.6428571428571,NA
"2011-W28",NA,NA,NA,NA,0,0,0,0,0,0,0,0,0,0,0,27.4553571428571,72.0178571428571,NA
"2011-W29",NA,NA,NA,NA,0,0,0,0,0,0,0,0,0,0,0,28.1625,69.8571428571429,NA
"2011-W30",2.06274509803922,NA,NA,2011-07-27,0,0,0,0,0,0,0,0,0,0,0,29.0232142857143,69.0714285714286,NA
"2011-W31",NA,NA,NA,NA,0,0,0,0,0,0,0,0,0,0,0,28.8142857142857,69.5,NA
"2011-W32",NA,NA,NA,NA,0,0,0,0,0,0,0,0,0,0,0,28.4428571428571,69.5535714285714,NA
"2011-W33",NA,NA,NA,NA,1,1,0,1,0,1,1,0,1,0,0,27.6285714285714,68.3571428571429,"2011-08-14 UTC--2011-08-20 UTC"
"2011-W34",2.04007633587786,NA,NA,2011-08-24,0,0,0,0,0,0,0,0,0,0,0,27.9660714285714,70.7142857142857,NA
"2011-W35",NA,NA,NA,NA,0,0,0,0,0,0,0,0,0,0,0,27.3660714285714,65.0892857142857,NA
"2011-W36",NA,NA,NA,NA,0,0,0,0,0,0,0,0,0,0,0,27.1464285714286,69.1428571428571,NA
"2011-W37",NA,NA,NA,NA,0,0,0,0,0,0,0,0,0,0,0,26.9053571428571,70.9642857142857,NA
"2011-W38",NA,NA,NA,NA,1,0,1,1,0,2,0,2,2,0,0,26.4214285714286,68.8214285714286,"2011-09-18 UTC--2011-09-24 UTC"
"2011-W39",NA,NA,NA,NA,0,0,0,0,0,0,0,0,0,0,0,26.0214285714286,67.6785714285714,NA
"2011-W40",1.93529411764706,NA,NA,2011-10-02,0,0,0,0,0,0,0,0,0,0,0,24.5928571428571,63.9642857142857,NA
"2011-W41",NA,NA,NA,NA,0,0,0,0,0,0,0,0,0,0,0,25.0392857142857,57.0714285714286,NA
"2011-W42",NA,NA,NA,NA,0,0,0,0,0,0,0,0,0,0,0,22.9553571428571,58.6428571428571,NA
"2011-W43",NA,NA,NA,NA,1,1,0,1,0,1,1,0,1,0,0,22.2107142857143,64.3214285714286,"2011-10-23 UTC--2011-10-29 UTC"
"2011-W44",1.92054263565891,NA,NA,2011-11-01,0,0,0,0,0,0,0,0,0,0,0,19.2571428571429,64.3392857142857,NA
"2011-W45",NA,NA,NA,NA,0,0,0,0,0,0,0,0,0,0,0,18,60.3571428571429,NA
"2011-W46",NA,NA,NA,NA,0,0,0,0,0,0,0,0,0,0,0,16.5321428571429,75.5892857142857,NA
"2011-W47",NA,NA,NA,NA,0,0,0,0,0,0,0,0,0,0,0,15.0517857142857,73.3214285714286,NA
"2011-W48",NA,NA,NA,NA,0,0,0,0,0,0,0,0,0,0,0,12.9196428571429,57.9642857142857,NA
"2011-W49",2.01717557251908,NA,NA,2011-12-06,0,0,0,0,0,0,0,0,0,0,0,14.2142857142857,58.1428571428571,NA
"2011-W50",NA,NA,NA,NA,0,0,0,0,0,0,0,0,0,0,0,13.6035714285714,70.6071428571429,NA
"2011-W51",NA,NA,NA,NA,0,0,0,0,0,0,0,0,0,0,0,16.7785714285714,60.9821428571429,NA
"2011-W52",2.06470588235294,NA,NA,2011-12-28,0,0,0,0,0,0,0,0,0,0,0,13.1714285714286,71.3392857142857,NA
"2012-W01",NA,NA,NA,NA,0,0,0,0,0,0,0,0,0,0,0,13.0125,74.6964285714286,NA
"2012-W02",NA,NA,NA,NA,0,0,0,0,0,0,0,0,0,0,0,11.5928571428571,72.0535714285714,NA
"2012-W03",NA,NA,NA,NA,0,0,0,0,0,0,0,0,0,0,0,11.7428571428571,71.3392857142857,NA
"2012-W04",NA,NA,NA,NA,0,0,0,0,0,0,0,0,0,0,0,13.2553571428571,74.9285714285714,NA
"2012-W05",2.00978473581213,NA,NA,2012-01-31,0,0,0,0,0,0,0,0,0,0,0,12.6607142857143,75.2321428571429,NA
"2012-W06",NA,NA,NA,NA,0,0,0,0,0,0,0,0,0,0,0,13.1714285714286,57.5714285714286,NA
"2012-W07",NA,NA,NA,NA,0,0,0,0,0,0,0,0,0,0,0,14.0339285714286,63.4107142857143,NA
"2012-W08",NA,NA,NA,NA,0,0,0,0,0,0,0,0,0,0,0,12.9410714285714,64.0892857142857,NA
"2012-W09",2.00588235294118,NA,NA,2012-02-29,0,0,0,0,0,0,0,0,0,0,0,11.9767857142857,76.1607142857143,NA
"2012-W10",NA,NA,NA,NA,0,0,0,0,0,0,0,0,0,0,0,14.1142857142857,76.3928571428571,NA
"2012-W11",NA,NA,NA,NA,0,0,0,0,0,0,0,0,0,0,0,16.0714285714286,62.4107142857143,NA
"2012-W12",NA,NA,NA,NA,0,0,0,0,0,0,0,0,0,0,0,14.5160714285714,59.6428571428571,NA
"2012-W13",NA,NA,NA,NA,0,0,0,0,0,0,0,0,0,0,0,15.5089285714286,73.2678571428571,NA
"2012-W14",NA,NA,NA,NA,0,0,0,0,0,0,0,0,0,0,0,18.9142857142857,66.6964285714286,NA
"2012-W15",NA,NA,NA,NA,0,0,0,0,0,0,0,0,0,0,0,19.5517857142857,63.3214285714286,NA
"2012-W16",NA,NA,NA,NA,0,0,0,0,0,0,0,0,0,0,0,19.9267857142857,61.5,NA
"2012-W17",NA,NA,NA,NA,0,0,0,0,0,0,0,0,0,0,0,18.9107142857143,70.6785714285714,NA
"2012-W18",1.99411764705882,NA,NA,2012-05-02,0,0,0,0,0,0,0,0,0,0,0,21.3928571428571,68.5535714285714,NA
"2012-W19",NA,NA,NA,NA,0,0,0,0,0,0,0,0,0,0,0,21.8696428571429,67.9821428571429,NA
"2012-W20",NA,NA,NA,NA,0,0,0,0,0,0,0,0,0,0,0,22.7553571428571,65.3392857142857,NA
"2012-W21",NA,NA,NA,NA,0,0,0,0,0,0,0,0,0,0,0,22.8785714285714,62.6428571428571,NA
"2012-W22",1.98627450980392,NA,NA,2012-05-31,1,0,1,0,1,1,0,1,0,1,0,24.3767857142857,59.3035714285714,"2012-05-27 UTC--2012-06-02 UTC"
"2012-W23",2.01176470588235,NA,NA,2012-06-05,0,0,0,0,0,0,0,0,0,0,0,23.9857142857143,69.1785714285714,NA
"2012-W24",NA,NA,NA,NA,0,0,0,0,0,0,0,0,0,0,0,25.5678571428571,72.4107142857143,NA
"2012-W25",NA,NA,NA,NA,0,0,0,0,0,0,0,0,0,0,0,27.2910714285714,68.7857142857143,NA
"2012-W26",NA,NA,NA,NA,0,0,0,0,0,0,0,0,0,0,0,27.2303571428571,71.75,NA
"2012-W27",NA,NA,NA,NA,0,0,0,0,0,0,0,0,0,0,0,27.8660714285714,69.0178571428571,NA
"2012-W28",NA,NA,NA,NA,0,0,0,0,0,0,0,0,0,0,0,28.4,70.5535714285714,NA
"2012-W29",NA,NA,NA,NA,0,0,0,0,0,0,0,0,0,0,0,29.4964285714286,70.8928571428571,NA
"2012-W30",NA,NA,NA,NA,0,0,0,0,0,0,0,0,0,0,0,29.525,69.125,NA
"2012-W31",NA,NA,NA,NA,0,0,0,0,0,0,0,0,0,0,0,29.7178571428571,64.2678571428571,NA
"2012-W32",2.07058823529412,NA,NA,2012-08-06,0,0,0,0,0,0,0,0,0,0,0,29.3910714285714,68.6428571428571,NA
"2012-W32",2.01937984496124,NA,NA,2012-08-08,0,0,0,0,0,0,0,0,0,0,0,29.3910714285714,68.6428571428571,NA
"2012-W33",NA,NA,NA,NA,0,0,0,0,0,0,0,0,0,0,0,29.0107142857143,67.6785714285714,NA
"2012-W34",NA,NA,NA,NA,0,0,0,0,0,0,0,0,0,0,0,28.9928571428571,67.5,NA
"2012-W35",NA,NA,NA,NA,0,0,0,0,0,0,0,0,0,0,0,28.1392857142857,66.8571428571429,NA
"2012-W36",NA,NA,NA,NA,0,0,0,0,0,0,0,0,0,0,0,28.2446428571429,67.8928571428571,NA
"2012-W37",NA,NA,NA,NA,0,0,0,0,0,0,0,0,0,0,0,27.2732142857143,64.2321428571429,NA
"2012-W38",NA,NA,NA,NA,0,0,0,0,0,0,0,0,0,0,0,26.7357142857143,66.9285714285714,NA
"2012-W39",NA,NA,NA,NA,0,0,0,0,0,0,0,0,0,0,0,26.075,67.5892857142857,NA
"2012-W40",NA,NA,NA,NA,0,0,0,0,0,0,0,0,0,0,0,26.9285714285714,70.125,NA
"2012-W41",NA,NA,NA,NA,0,0,0,0,0,0,0,0,0,0,0,24.9625,65.0178571428571,NA
"2012-W42",NA,NA,NA,NA,0,0,0,0,0,0,0,0,0,0,0,25.3107142857143,72.1785714285714,NA
"2012-W43",2.00191938579654,NA,NA,2012-10-24,0,0,0,0,0,0,0,0,0,0,0,23.1714285714286,68.5535714285714,NA
"2012-W44",NA,NA,NA,NA,0,0,0,0,0,0,0,0,0,0,0,23.4035714285714,66.3392857142857,NA
"2012-W45",NA,NA,NA,NA,0,0,0,0,0,0,0,0,0,0,0,22.7142857142857,69.2321428571429,NA
"2012-W46",NA,NA,NA,NA,1,1,0,1,0,3,3,0,3,0,0,20.0142857142857,67.6785714285714,"2012-11-11 UTC--2012-11-17 UTC"
"2012-W47",NA,NA,NA,NA,2,2,0,2,0,3,3,0,3,0,0,19.0053571428571,77.4464285714286,"2012-11-18 UTC--2012-11-24 UTC"
"2012-W48",NA,NA,NA,NA,0,0,0,0,0,0,0,0,0,0,0,17.6125,71.5178571428571,NA
"2012-W49",2.03522504892368,NA,NA,2012-12-02,0,0,0,0,0,0,0,0,0,0,0,17.8232142857143,73.3214285714286,NA
"2012-W50",NA,NA,NA,NA,0,0,0,0,0,0,0,0,0,0,0,15.6821428571429,76.0535714285714,NA
"2012-W51",NA,NA,NA,NA,0,0,0,0,0,0,0,0,0,0,0,14.9875,69.9821428571429,NA
"2012-W52",NA,NA,NA,NA,0,0,0,0,0,0,0,0,0,0,0,14.3803571428571,78.1785714285714,NA
"2012-W53",NA,NA,NA,NA,0,0,0,0,0,0,0,0,0,0,0,14.51875,76.4375,NA
"2013-W00",1.93957115009747,NA,NA,2013-01-02,0,0,0,0,0,0,0,0,0,0,0,14.1725,79.625,NA
"2013-W00",1.95348837209302,NA,NA,2013-01-04,0,0,0,0,0,0,0,0,0,0,0,14.1725,79.625,NA
"2013-W01",NA,NA,NA,NA,0,0,0,0,0,0,0,0,0,0,0,11.1089285714286,72.5357142857143,NA
"2013-W02",NA,NA,NA,NA,0,0,0,0,0,0,0,0,0,0,0,13.15,65.3392857142857,NA
"2013-W03",NA,NA,NA,NA,0,0,0,0,0,0,0,0,0,0,0,15.1625,72.75,NA
"2013-W04",NA,NA,NA,NA,0,0,0,0,0,0,0,0,0,0,0,13.5892857142857,81.6607142857143,NA
"2013-W05",NA,NA,NA,NA,0,0,0,0,0,0,0,0,0,0,0,15.1625,70.3214285714286,NA
"2013-W06",NA,NA,NA,NA,0,0,0,0,0,0,0,0,0,0,0,14.4261904761905,72,NA
"2013-W07",NA,NA,NA,NA,0,0,0,0,0,0,0,0,0,0,0,15.2232142857143,70.0357142857143,NA
"2013-W08",NA,NA,NA,NA,0,0,0,0,0,0,0,0,0,0,0,16.9464285714286,69.3035714285714,NA
"2013-W09",NA,NA,NA,NA,0,0,0,0,0,0,0,0,0,0,0,17.6285714285714,53.2857142857143,NA
"2013-W10",NA,NA,NA,NA,0,0,0,0,0,0,0,0,0,0,0,21.0535714285714,56.6785714285714,NA
"2013-W11",NA,NA,NA,NA,0,0,0,0,0,0,0,0,0,0,0,17.4160714285714,61.4107142857143,NA
"2013-W12",NA,NA,NA,NA,0,0,0,0,0,0,0,0,0,0,0,18.3982142857143,62.4107142857143,NA
"2013-W13",1.98428290766208,NA,NA,2013-03-31,0,0,0,0,0,0,0,0,0,0,0,19.9625,63.7321428571429,NA
"2013-W14",NA,NA,NA,NA,0,0,0,0,0,0,0,0,0,0,0,19.2142857142857,63.5357142857143,NA
"2013-W15",NA,NA,NA,NA,0,0,0,0,0,0,0,0,0,0,0,17.2946428571429,71.375,NA
"2013-W16",NA,NA,NA,NA,0,0,0,0,0,0,0,0,0,0,0,20.4267857142857,57.6964285714286,NA
"2013-W17",1.83433133732535,NA,NA,2013-04-30,1,0,1,1,0,1,0,1,1,0,0,24.8892857142857,46.1428571428571,"2013-04-28 UTC--2013-05-04 UTC"
"2013-W18",NA,NA,NA,NA,0,0,0,0,0,0,0,0,0,0,0,22.5339285714286,73.1607142857143,NA
"2013-W19",NA,NA,NA,NA,0,0,0,0,0,0,0,0,0,0,0,21.7482142857143,66.1071428571429,NA
"2013-W20",NA,NA,NA,NA,0,0,0,0,0,0,0,0,0,0,0,23.9928571428571,67.0535714285714,NA
"2013-W21",1.99412915851272,NA,NA,2013-05-30,0,0,0,0,0,0,0,0,0,0,0,24.4946428571429,61.1071428571429,NA
"2013-W22",NA,NA,NA,NA,0,0,0,0,0,0,0,0,0,0,0,25.4071428571429,57.4642857142857,NA
"2013-W23",NA,NA,NA,NA,0,0,0,0,0,0,0,0,0,0,0,25.1482142857143,63.0357142857143,NA
"2013-W24",NA,NA,NA,NA,0,0,0,0,0,0,0,0,0,0,0,25.9642857142857,66.25,NA
"2013-W25",NA,NA,NA,NA,0,0,0,0,0,0,0,0,0,0,0,26.6035714285714,70.1964285714286,NA
"2013-W26",2.44417475728155,NA,NA,2013-07-03,0,0,0,0,0,0,0,0,0,0,0,26.4428571428571,63.3392857142857,NA
"2013-W27",NA,NA,NA,NA,0,0,0,0,0,0,0,0,0,0,0,26.8553571428571,65.7142857142857,NA
"2013-W28",NA,NA,NA,NA,0,0,0,0,0,0,0,0,0,0,0,27.1625,68.8035714285714,NA
"2013-W29",NA,NA,NA,NA,0,0,0,0,0,0,0,0,0,0,0,27.2892857142857,70.6428571428571,NA
"2013-W30",2.00199203187251,NA,NA,2013-07-30,0,0,0,0,0,0,0,0,0,0,0,27.5464285714286,70,NA
"2013-W31",NA,NA,NA,NA,0,0,0,0,0,0,0,0,0,0,0,27.7732142857143,70.4285714285714,NA
"2013-W32",NA,NA,NA,NA,0,0,0,0,0,0,0,0,0,0,0,28.1839285714286,69.6071428571429,NA
"2013-W33",NA,NA,NA,NA,0,0,0,0,0,0,0,0,0,0,0,27.8982142857143,68.4285714285714,NA
"2013-W34",2.00596421471173,NA,NA,2013-08-28,0,0,0,0,0,0,0,0,0,0,0,27.7767857142857,68.7142857142857,NA
"2013-W35",NA,NA,NA,NA,0,0,0,0,0,0,0,0,0,0,0,27.3339285714286,63.2678571428571,NA
"2013-W36",NA,NA,NA,NA,0,0,0,0,0,0,0,0,0,0,0,26.7321428571429,65.1964285714286,NA
"2013-W37",NA,NA,NA,NA,1,0,1,1,0,1,0,1,1,0,0,26.8107142857143,61.9821428571429,"2013-09-15 UTC--2013-09-21 UTC"
"2013-W38",NA,NA,NA,NA,1,0,1,0,1,1,0,1,0,1,0,24.8214285714286,61.25,"2013-09-22 UTC--2013-09-28 UTC"
"2013-W39",2.09362549800797,NA,NA,2013-10-01,0,0,0,0,0,0,0,0,0,0,0,24.3946428571429,60.3928571428571,NA
"2013-W40",NA,NA,NA,NA,1,0,1,1,0,1,0,1,1,0,0,22.2285714285714,45.7678571428571,"2013-10-06 UTC--2013-10-12 UTC"
"2013-W41",NA,NA,NA,NA,0,0,0,0,0,0,0,0,0,0,0,22.1375,68.375,NA
"2013-W42",NA,NA,NA,NA,0,0,0,0,0,0,0,0,0,0,0,21.2017857142857,57.2857142857143,NA
"2013-W43",2.066,NA,NA,2013-10-29,0,0,0,0,0,0,0,0,0,0,0,21.1553571428571,58.7142857142857,NA
"2013-W44",NA,NA,NA,NA,0,0,0,0,0,0,0,0,0,0,0,22.2196428571429,60.4464285714286,NA
"2013-W45",NA,NA,NA,NA,1,1,0,1,0,1,1,0,1,0,0,20.6535714285714,64.8571428571429,"2013-11-10 UTC--2013-11-16 UTC"
"2013-W46",NA,NA,NA,NA,0,0,0,0,0,0,0,0,0,0,0,18.3017857142857,67.2142857142857,NA
"2013-W47",2.004,NA,NA,2013-11-28,0,0,0,0,0,0,0,0,0,0,0,21.0232142857143,55.0892857142857,NA
"2013-W48",NA,NA,NA,NA,0,0,0,0,0,0,0,0,0,0,0,19.5660714285714,63.0892857142857,NA
"2013-W49",NA,NA,NA,NA,0,0,0,0,0,0,0,0,0,0,0,10.7392857142857,78.9285714285714,NA
"2013-W50",NA,NA,NA,NA,0,0,0,0,0,0,0,0,0,0,0,9.99642857142857,68.5178571428571,NA
"2013-W51",NA,NA,NA,NA,1,1,0,1,0,1,1,0,1,0,0,13.8946428571429,49.4642857142857,"2013-12-22 UTC--2013-12-28 UTC"
"2013-W52",2.08349900596421,NA,NA,2013-12-31,0,0,0,0,0,0,0,0,0,0,0,12.525,75.25,NA
"2014-W00",NA,NA,NA,NA,0,0,0,0,0,0,0,0,0,0,0,12.425,77.34375,NA
"2014-W01",NA,NA,NA,NA,0,0,0,0,0,0,0,0,0,0,0,12.7428571428571,64.625,NA
"2014-W02",NA,NA,NA,NA,0,0,0,0,0,0,0,0,0,0,0,14.3696428571429,74.875,NA
"2014-W03",NA,NA,NA,NA,0,0,0,0,0,0,0,0,0,0,0,13.6803571428571,75.6607142857143,NA
"2014-W04",1.98816568047337,NA,NA,2014-01-29,0,0,0,0,0,0,0,0,0,0,0,14.7660714285714,67.0714285714286,NA
"2014-W05",NA,NA,NA,NA,0,0,0,0,0,0,0,0,0,0,0,12.1642857142857,55.0535714285714,NA
"2014-W06",NA,NA,NA,NA,0,0,0,0,0,0,0,0,0,0,0,14.1821428571429,61.75,NA
"2014-W07",NA,NA,NA,NA,0,0,0,0,0,0,0,0,0,0,0,15.3357142857143,69.0714285714286,NA
"2014-W08",NA,NA,NA,NA,0,0,0,0,0,0,0,0,0,0,0,15.2875,72.1607142857143,NA
"2014-W09",2,NA,NA,2014-03-04,0,0,0,0,0,0,0,0,0,0,0,18.9535714285714,57.5357142857143,NA
"2014-W10",NA,NA,NA,NA,0,0,0,0,0,0,0,0,0,0,0,14.3160714285714,76.8035714285714,NA
"2014-W11",NA,NA,NA,NA,0,0,0,0,0,0,0,0,0,0,0,16.9857142857143,73.875,NA
"2014-W12",NA,NA,NA,NA,0,0,0,0,0,0,0,0,0,0,0,17.8392857142857,72.0714285714286,NA
"2014-W13",2.128,NA,NA,2014-03-31,0,0,0,0,0,0,0,0,0,0,0,16.8285714285714,61.7678571428571,NA
"2014-W14",NA,NA,NA,NA,0,0,0,0,0,0,0,0,0,0,0,18.8875,63.9107142857143,NA
"2014-W15",NA,NA,NA,NA,1,0,1,1,0,2,0,2,2,0,0,21.6321428571429,53.1428571428571,"2014-04-13 UTC--2014-04-19 UTC"
"2014-W16",NA,NA,NA,NA,0,0,0,0,0,0,0,0,0,0,0,21.5642857142857,64.8928571428571,NA
"2014-W17",2.078,NA,NA,2014-04-29,0,0,0,0,0,0,0,0,0,0,0,21.5589285714286,59.8035714285714,NA
"2014-W18",NA,NA,NA,NA,0,0,0,0,0,0,0,0,0,0,0,23.7803571428571,55.5892857142857,NA
"2014-W19",NA,NA,NA,NA,0,0,0,0,0,0,0,0,0,0,0,21.0821428571429,65.1428571428571,NA
"2014-W20",NA,NA,NA,NA,0,0,0,0,0,0,0,0,0,0,0,22.3375,64.4107142857143,NA
"2014-W21",1.89306930693069,NA,NA,2014-05-29,0,0,0,0,0,0,0,0,0,0,0,24.4446428571429,60.5714285714286,NA
"2014-W22",NA,NA,NA,NA,0,0,0,0,0,0,0,0,0,0,0,24.8509090909091,56.1454545454545,NA
"2014-W23",NA,NA,NA,NA,1,0,1,1,0,3,0,3,3,0,0,24.0910714285714,67.6607142857143,"2014-06-08 UTC--2014-06-14 UTC"
"2014-W24",NA,NA,NA,NA,0,0,0,0,0,0,0,0,0,0,0,26.2107142857143,62.4285714285714,NA
"2014-W25",NA,NA,NA,NA,0,0,0,0,0,0,0,0,0,0,0,26.1375,66.5535714285714,NA
"2014-W26",2.02390438247012,NA,NA,2014-06-30,0,0,0,0,0,0,0,0,0,0,0,27.15,68.875,NA
"2014-W27",NA,NA,NA,NA,0,0,0,0,0,0,0,0,0,0,0,27.1232142857143,66.9642857142857,NA
"2014-W28",NA,NA,NA,NA,4,3,1,2,2,6,4,2,2,4,0,27.1892857142857,62.5,"2014-07-13 UTC--2014-07-19 UTC"
"2014-W29",2.24537037037037,NA,NA,2014-07-23,13,2,11,0,13,36,5,31,0,36,0,27.2089285714286,67.0357142857143,"2014-07-20 UTC--2014-07-26 UTC"
"2014-W30",NA,NA,NA,NA,6,3,3,0,6,21,14,7,0,21,0,27.4267857142857,68.375,"2014-07-27 UTC--2014-08-02 UTC"
"2014-W31",NA,NA,NA,NA,1,1,0,1,0,1,1,0,1,0,0,27.9392857142857,65.7857142857143,"2014-08-03 UTC--2014-08-09 UTC"
"2014-W32",1.3,NA,NA,2014-08-12,0,0,0,0,0,0,0,0,0,0,0,27.9928571428571,69.1071428571429,NA
"2014-W33",NA,NA,NA,NA,2,2,0,2,0,2,2,0,2,0,0,28.1196428571429,67.1964285714286,"2014-08-17 UTC--2014-08-23 UTC"
"2014-W34",NA,NA,NA,NA,1,1,0,1,0,2,2,0,2,0,0,28.0928571428571,70.3392857142857,"2014-08-24 UTC--2014-08-30 UTC"
"2014-W35",NA,NA,NA,NA,0,0,0,0,0,0,0,0,0,0,0,27.8125,63.8035714285714,NA
"2014-W36",NA,NA,NA,NA,0,0,0,0,0,0,0,0,0,0,0,27.0392857142857,61.9821428571429,NA
"2014-W37",2.14203454894434,NA,NA,2014-09-18,0,0,0,0,0,0,0,0,0,0,0,27.0625,60.5,NA
"2014-W38",NA,NA,NA,NA,0,0,0,0,0,0,0,0,0,0,0,26.4035714285714,62.5892857142857,NA
"2014-W39",NA,NA,NA,NA,0,0,0,0,0,0,0,0,0,0,0,24.4535714285714,62.625,NA
"2014-W40",NA,NA,NA,NA,0,0,0,0,0,0,0,0,0,0,0,23.975,68.6785714285714,NA
"2014-W41",NA,NA,NA,NA,0,0,0,0,0,0,0,0,0,0,0,23.0267857142857,66.8214285714286,NA
"2014-W42",NA,NA,NA,NA,1,0,1,1,0,2,0,2,2,0,0,21.1839285714286,62.2678571428571,"2014-10-19 UTC--2014-10-25 UTC"
"2014-W43",NA,NA,NA,NA,0,0,0,0,0,0,0,0,0,0,0,21.4767857142857,67.5178571428571,NA
"2014-W44",2.00198807157058,NA,NA,2014-11-05,1,1,0,1,0,4,4,0,4,0,0,20.2767857142857,55.7678571428571,"2014-11-02 UTC--2014-11-08 UTC"
"2014-W45",NA,NA,NA,NA,2,1,1,2,0,2,1,1,2,0,0,19.1839285714286,67.8571428571429,"2014-11-09 UTC--2014-11-15 UTC"
"2014-W46",NA,NA,NA,NA,1,1,0,1,0,6,6,0,6,0,0,19.1071428571429,67.8035714285714,"2014-11-16 UTC--2014-11-22 UTC"
"2014-W47",NA,NA,NA,NA,0,0,0,0,0,0,0,0,0,0,0,15.175,80.7321428571429,NA
"2014-W48",2.0796812749004,NA,NA,2014-12-03,0,0,0,0,0,0,0,0,0,0,0,17.4928571428571,75.1964285714286,NA
"2014-W49",NA,NA,NA,NA,0,0,0,0,0,0,0,0,0,0,0,17.6678571428571,70.7142857142857,NA
"2014-W50",NA,NA,NA,NA,0,0,0,0,0,0,0,0,0,0,0,15.0178571428571,77.4464285714286,NA
"2014-W51",NA,NA,NA,NA,0,0,0,0,0,0,0,0,0,0,0,14.3071428571429,76.5357142857143,NA
"2014-W52",1.90818363273453,NA,NA,2014-12-31,0,0,0,0,0,0,0,0,0,0,0,13.49375,72.1875,NA
"2015-W00",NA,NA,NA,NA,0,0,0,0,0,0,0,0,0,0,0,13.2625,69.9583333333333,NA
"2015-W01",NA,NA,NA,NA,0,0,0,0,0,0,0,0,0,0,0,10.4964285714286,71.3928571428571,NA
"2015-W02",NA,NA,NA,NA,0,0,0,0,0,0,0,0,0,0,0,10.4303571428571,78.8214285714286,NA
"2015-W03",NA,NA,NA,NA,0,0,0,0,0,0,0,0,0,0,0,12.8285714285714,72.4107142857143,NA
"2015-W04",NA,NA,NA,NA,0,0,0,0,0,0,0,0,0,0,0,13.4785714285714,71.0892857142857,NA
"2015-W05",NA,NA,NA,NA,0,0,0,0,0,0,0,0,0,0,0,14.1927272727273,70.1454545454545,NA
"2015-W06",NA,NA,NA,NA,0,0,0,0,0,0,0,0,0,0,0,12.9910714285714,62.0535714285714,NA
"2015-W07",NA,NA,NA,NA,0,0,0,0,0,0,0,0,0,0,0,11.5785714285714,73.5892857142857,NA
"2015-W08",NA,NA,NA,NA,0,0,0,0,0,0,0,0,0,0,0,15.9571428571429,62.9642857142857,NA
"2015-W09",1.92814371257485,NA,NA,2015-03-03,0,0,0,0,0,0,0,0,0,0,0,16.8321428571429,62.9642857142857,NA
"2015-W10",NA,NA,NA,NA,0,0,0,0,0,0,0,0,0,0,0,17.6767857142857,69.6428571428571,NA
"2015-W11",NA,NA,NA,NA,0,0,0,0,0,0,0,0,0,0,0,15.2285714285714,66.4464285714286,NA
"2015-W12",NA,NA,NA,NA,0,0,0,0,0,0,0,0,0,0,0,19.0321428571429,52.5714285714286,NA
"2015-W13",1.98406374501992,NA,NA,2015-03-30,0,0,0,0,0,0,0,0,0,0,0,18.0303571428571,67.5357142857143,NA
"2015-W14",NA,NA,NA,NA,0,0,0,0,0,0,0,0,0,0,0,18.2857142857143,61.5357142857143,NA
"2015-W15",NA,NA,NA,NA,1,0,1,1,0,1,0,1,1,0,0,16.4214285714286,71.8214285714286,"2015-04-12 UTC--2015-04-18 UTC"
"2015-W16",NA,NA,NA,NA,0,0,0,0,0,0,0,0,0,0,0,18.2535714285714,58.1428571428571,NA
"2015-W17",NA,NA,NA,NA,0,0,0,0,0,0,0,0,0,0,0,20.5785714285714,64,NA
"2015-W18",2.01968503937008,NA,NA,2015-05-05,0,0,0,0,0,0,0,0,0,0,0,20.9910714285714,64.4821428571429,NA
"2015-W19",NA,NA,NA,NA,0,0,0,0,0,0,0,0,0,0,0,21.5357142857143,64.7142857142857,NA
"2015-W20",NA,NA,NA,NA,0,0,0,0,0,0,0,0,0,0,0,25.1428571428571,54.4107142857143,NA
"2015-W21",NA,NA,NA,NA,0,0,0,0,0,0,0,0,0,0,0,26.1821428571429,50.4642857142857,NA
"2015-W22",2.02745098039216,NA,NA,2015-06-04,0,0,0,0,0,0,0,0,0,0,0,22.7696428571429,64.2321428571429,NA
"2015-W23",NA,NA,NA,NA,0,0,0,0,0,0,0,0,0,0,0,24.6803571428571,63.8928571428571,NA
"2015-W24",NA,NA,NA,NA,1,0,1,1,0,1,0,1,1,0,0,25.15,66.5535714285714,"2015-06-14 UTC--2015-06-20 UTC"
"2015-W25",NA,NA,NA,NA,0,0,0,0,0,0,0,0,0,0,0,25.2946428571429,60.6964285714286,NA
"2015-W26",2.12645914396887,NA,NA,2015-07-01,1,0,1,1,0,1,0,1,1,0,0,25.4125,65.6964285714286,"2015-06-28 UTC--2015-07-04 UTC"
"2015-W27",NA,NA,NA,NA,0,0,0,0,0,0,0,0,0,0,0,25.6553571428571,67.5892857142857,NA
"2015-W28",NA,NA,NA,NA,0,0,0,0,0,0,0,0,0,0,0,26.7785714285714,70.1071428571429,NA
"2015-W29",NA,NA,NA,NA,0,0,0,0,0,0,0,0,0,0,0,27.6214285714286,68.7321428571429,NA
"2015-W30",2.1126213592233,NA,NA,2015-07-30,0,0,0,0,0,0,0,0,0,0,0,27.9767857142857,67.5178571428571,NA
"2015-W31",NA,NA,NA,NA,0,0,0,0,0,0,0,0,0,0,0,30.1803571428571,66,NA
"2015-W32",NA,NA,NA,NA,0,0,0,0,0,0,0,0,0,0,0,29.0321428571429,67.4464285714286,NA
"2015-W33",NA,NA,NA,NA,0,0,0,0,0,0,0,0,0,0,0,29.6446428571429,65.9285714285714,NA
"2015-W34",NA,NA,NA,NA,0,0,0,0,0,0,0,0,0,0,0,28.5857142857143,64.1428571428571,NA
"2015-W35",2.00588235294118,NA,NA,2015-08-31,0,0,0,0,0,0,0,0,0,0,0,28.4892857142857,66.3392857142857,NA
"2015-W36",NA,NA,NA,NA,0,0,0,0,0,0,0,0,0,0,0,29.6839285714286,71.4285714285714,NA
"2015-W37",NA,NA,NA,NA,1,0,1,1,0,1,0,1,1,0,0,28.2285714285714,67.7142857142857,"2015-09-13 UTC--2015-09-19 UTC"
"2015-W38",NA,NA,NA,NA,0,0,0,0,0,0,0,0,0,0,0,27.7910714285714,55.0892857142857,NA
"2015-W39",NA,NA,NA,NA,2,0,2,2,0,5,0,5,5,0,0,26.7,67.0178571428571,"2015-09-27 UTC--2015-10-03 UTC"
"2015-W40",2.10019646365422,NA,NA,2015-10-08,0,0,0,0,0,0,0,0,0,0,0,25.1107142857143,70.0714285714286,NA
"2015-W41",NA,NA,NA,NA,2,1,1,2,0,4,1,3,4,0,0,25.2571428571429,69.9107142857143,"2015-10-11 UTC--2015-10-17 UTC"
"2015-W42",NA,NA,NA,NA,1,0,1,1,0,1,0,1,1,0,0,25.0875,66.5,"2015-10-18 UTC--2015-10-24 UTC"
"2015-W43",2.044921875,NA,NA,2015-10-29,0,0,0,0,0,0,0,0,0,0,0,20.6267857142857,78.0535714285714,NA
"2015-W44",NA,NA,NA,NA,1,0,1,0,1,1,0,1,0,1,0,21.9285714285714,64,"2015-11-01 UTC--2015-11-07 UTC"
"2015-W45",NA,NA,NA,NA,1,0,1,1,0,2,0,2,2,0,0,19.2178571428571,68.4821428571429,"2015-11-08 UTC--2015-11-14 UTC"
"2015-W46",NA,NA,NA,NA,2,1,1,2,0,3,2,1,3,0,0,19.4267857142857,70.1428571428571,"2015-11-15 UTC--2015-11-21 UTC"
"2015-W47",NA,NA,NA,NA,2,0,2,2,0,2,0,2,2,0,0,18.9821428571429,58.4642857142857,"2015-11-22 UTC--2015-11-28 UTC"
"2015-W48",2.15094339622642,NA,NA,2015-12-01,0,0,0,0,0,0,0,0,0,0,0,15.3107142857143,67.3035714285714,NA
"2015-W49",NA,NA,NA,NA,1,0,1,1,0,1,0,1,1,0,0,12.1517857142857,67.75,"2015-12-06 UTC--2015-12-12 UTC"
"2015-W50",NA,NA,NA,NA,0,0,0,0,0,0,0,0,0,0,0,13.6589285714286,81.8928571428571,NA
"2015-W51",NA,NA,NA,NA,1,0,1,1,0,1,0,1,1,0,0,12.7839285714286,71.2142857142857,"2015-12-20 UTC--2015-12-26 UTC"
"2015-W52",2.052,NA,NA,2015-12-29,0,0,0,0,0,0,0,0,0,0,0,15.375,62.05,NA
"2015-W52",2.0597609561753,NA,NA,2015-12-30,0,0,0,0,0,0,0,0,0,0,0,15.375,62.05,NA
"2016-W00",NA,NA,NA,NA,0,0,0,0,0,0,0,0,0,0,0,11.1375,71.1875,NA
"2016-W01",NA,NA,NA,NA,0,0,0,0,0,0,0,0,0,0,0,14.4767857142857,68.5178571428571,NA
"2016-W02",NA,NA,NA,NA,0,0,0,0,0,0,0,0,0,0,0,13.1464285714286,78.0714285714286,NA
"2016-W03",NA,NA,NA,NA,1,0,1,1,0,1,0,1,1,0,0,12.7928571428571,73.1785714285714,"2016-01-17 UTC--2016-01-23 UTC"
"2016-W04",2.17,NA,NA,2016-01-28,1,0,1,1,0,1,0,1,1,0,0,8.5375,75.7142857142857,"2016-01-24 UTC--2016-01-30 UTC"
"2016-W05",NA,NA,NA,NA,1,0,1,0,1,1,0,1,0,1,0,12.7982142857143,71.5535714285714,"2016-01-31 UTC--2016-02-06 UTC"
"2016-W06",NA,NA,NA,NA,0,0,0,0,0,0,0,0,0,0,0,12.875,77.0178571428571,NA
"2016-W07",NA,NA,NA,NA,1,0,1,1,0,1,0,1,1,0,0,18.1017857142857,63.8035714285714,"2016-02-14 UTC--2016-02-20 UTC"
"2016-W08",NA,NA,NA,NA,0,0,0,0,0,0,0,0,0,0,0,14.8714285714286,80.7678571428571,NA
"2016-W09",2.16966067864271,NA,NA,2016-03-01,0,0,0,0,0,0,0,0,0,0,0,18.6089285714286,61.2857142857143,NA
"2016-W10",NA,NA,NA,NA,0,0,0,0,0,0,0,0,0,0,0,17.3410714285714,66.9107142857143,NA
"2016-W11",NA,NA,NA,NA,0,0,0,0,0,0,0,0,0,0,0,17.4339285714286,63.9107142857143,NA
"2016-W12",NA,NA,NA,NA,0,0,0,0,0,0,0,0,0,0,0,19.1535714285714,54.375,NA
"2016-W13",2.138,NA,NA,2016-03-30,0,0,0,0,0,0,0,0,0,0,0,17.2696428571429,58.8214285714286,NA
"2016-W14",NA,NA,NA,NA,0,0,0,0,0,0,0,0,0,0,0,21.0553571428571,59.2321428571429,NA
"2016-W15",NA,NA,NA,NA,0,0,0,0,0,0,0,0,0,0,0,19.3910714285714,69.2321428571429,NA
"2016-W16",NA,NA,NA,NA,0,0,0,0,0,0,0,0,0,0,0,22.0553571428571,58.5,NA
"2016-W17",NA,NA,NA,NA,0,0,0,0,0,0,0,0,0,0,0,22.7821428571429,54.5892857142857,NA
"2016-W18",2.092,NA,NA,2016-05-03,0,0,0,0,0,0,0,0,0,0,0,22.2446428571429,58.6964285714286,NA
"2016-W19",NA,NA,NA,NA,0,0,0,0,0,0,0,0,0,0,0,22.2589285714286,58.9464285714286,NA
"2016-W20",NA,NA,NA,NA,0,0,0,0,0,0,0,0,0,0,0,24.6767857142857,55.4464285714286,NA
"2016-W21",NA,NA,NA,NA,0,0,0,0,0,0,0,0,0,0,0,23.3017857142857,58.25,NA
"2016-W22",2.13,NA,NA,2016-06-01,0,0,0,0,0,0,0,0,0,0,0,25.1071428571429,52.75,NA
"2016-W23",NA,NA,NA,NA,1,1,0,1,0,3,3,0,3,0,0,25.2714285714286,55.9642857142857,"2016-06-05 UTC--2016-06-11 UTC"
"2016-W24",NA,NA,NA,NA,0,0,0,0,0,0,0,0,0,0,0,26.0178571428571,61.8214285714286,NA
"2016-W25",NA,NA,NA,NA,0,0,0,0,0,0,0,0,0,0,0,27.5,68.3214285714286,NA
"2016-W26",2.282,NA,NA,2016-06-29,2,0,2,2,0,2,0,2,2,0,0,27.4785714285714,71.4107142857143,"2016-06-26 UTC--2016-07-02 UTC"
"2016-W27",NA,NA,NA,NA,0,0,0,0,0,0,0,0,0,0,0,27.6625,69.4642857142857,NA
"2016-W28",NA,NA,NA,NA,0,0,0,0,0,0,0,0,0,0,0,27.8732142857143,70.8392857142857,NA
"2016-W29",NA,NA,NA,NA,0,0,0,0,0,0,0,0,0,0,0,27.8446428571429,63.625,NA
"2016-W30",2.112,NA,NA,2016-07-27,0,0,0,0,0,0,0,0,0,0,0,28.0482142857143,70.6428571428571,NA
"2016-W31",NA,NA,NA,NA,0,0,0,0,0,0,0,0,0,0,0,28.5071428571429,70.6964285714286,NA
"2016-W32",NA,NA,NA,NA,0,0,0,0,0,0,0,0,0,0,0,28.4625,68.3035714285714,NA
"2016-W33",NA,NA,NA,NA,0,0,0,0,0,0,0,0,0,0,0,28.2428571428571,66.7857142857143,NA
"2016-W34",NA,NA,NA,NA,0,0,0,0,0,0,0,0,0,0,0,28.4446428571429,67,NA
"2016-W35",2.06,NA,NA,2016-08-31,0,0,0,0,0,0,0,0,0,0,0,27.9053571428571,63.5357142857143,NA
"2016-W36",NA,NA,NA,NA,0,0,0,0,0,0,0,0,0,0,0,27.1053571428571,66.4642857142857,NA
"2016-W37",NA,NA,NA,NA,0,0,0,0,0,0,0,0,0,0,0,27.1357142857143,66.6071428571429,NA
"2016-W38",NA,NA,NA,NA,0,0,0,0,0,0,0,0,0,0,0,26.6857142857143,65.0535714285714,NA
"2016-W39",NA,NA,NA,NA,0,0,0,0,0,0,0,0,0,0,0,24.8714285714286,58.1071428571429,NA
"2016-W40",NA,NA,NA,NA,0,0,0,0,0,0,0,0,0,0,0,25.0375,61.0892857142857,NA
"2016-W41",2.07797270955166,NA,NA,2016-10-09,1,0,1,1,0,2,0,2,2,0,0,24.1660714285714,69.25,"2016-10-09 UTC--2016-10-15 UTC"
"2016-W42",NA,NA,NA,NA,0,0,0,0,0,0,0,0,0,0,0,22.9803571428571,64.7678571428571,NA
"2016-W43",NA,NA,NA,NA,0,0,0,0,0,0,0,0,0,0,0,23.0642857142857,67.2321428571429,NA
"2016-W44",2.14,NA,NA,2016-10-31,0,0,0,0,0,0,0,0,0,0,0,21.2107142857143,64.8571428571429,NA
"2016-W45",NA,NA,NA,NA,0,0,0,0,0,0,0,0,0,0,0,20.0017857142857,64.4107142857143,NA
"2016-W46",NA,NA,NA,NA,0,0,0,0,0,0,0,0,0,0,0,20.0696428571429,63.1964285714286,NA
"2016-W47",NA,NA,NA,NA,0,0,0,0,0,0,0,0,0,0,0,18.6303571428571,14.8392857142857,NA
"2016-W48",2.072,NA,NA,2016-12-01,0,0,0,0,0,0,0,0,0,0,0,16.1321428571429,55.9107142857143,NA
"2016-W49",NA,NA,NA,NA,0,0,0,0,0,0,0,0,0,0,0,13.9517857142857,69.6607142857143,NA
"2016-W50",NA,NA,NA,NA,0,0,0,0,0,0,0,0,0,0,0,14.6339285714286,71.7678571428571,NA
"2016-W51",NA,NA,NA,NA,0,0,0,0,0,0,0,0,0,0,0,12.1589285714286,72.2142857142857,NA
"2016-W52",NA,NA,NA,NA,0,0,0,0,0,0,0,0,0,0,0,11.5732142857143,74.4285714285714,NA
"2017-W01",2.01996007984032,NA,NA,2017-01-03,0,0,0,0,0,0,0,0,0,0,0,11.6892857142857,75,NA
"2017-W02",NA,NA,NA,NA,1,0,1,1,0,4,0,4,4,0,0,11.8142857142857,65.625,"2017-01-08 UTC--2017-01-14 UTC"
"2017-W03",NA,NA,NA,NA,0,0,0,0,0,0,0,0,0,0,0,13,77.1964285714286,NA
"2017-W04",NA,NA,NA,NA,0,0,0,0,0,0,0,0,0,0,0,12.9732142857143,65.3571428571429,NA
"2017-W05",2.072,NA,NA,2017-02-01,0,0,0,0,0,0,0,0,0,0,0,9.82857142857143,69.7857142857143,NA
"2017-W06",NA,NA,NA,NA,0,0,0,0,0,0,0,0,0,0,0,13.9214285714286,66.5,NA
"2017-W07",NA,NA,NA,NA,0,0,0,0,0,0,0,0,0,0,0,10.4857142857143,79.2142857142857,NA
"2017-W08",NA,NA,NA,NA,0,0,0,0,0,0,0,0,0,0,0,12.2571428571429,68.9642857142857,NA
"2017-W09",2.004,NA,NA,2017-02-27,0,0,0,0,0,0,0,0,0,0,0,15.5642857142857,72.1428571428571,NA
"2017-W10",NA,NA,NA,NA,0,0,0,0,0,0,0,0,0,0,0,16.4946428571429,67.7321428571429,NA
"2017-W11",NA,NA,NA,NA,0,0,0,0,0,0,0,0,0,0,0,15.4303571428571,68.8214285714286,NA
"2017-W12",NA,NA,NA,NA,0,0,0,0,0,0,0,0,0,0,0,15.9053571428571,71.1964285714286,NA
"2017-W13",2.066,NA,NA,2017-03-29,0,0,0,0,0,0,0,0,0,0,0,17.1982142857143,66.2142857142857,NA
"2017-W14",NA,NA,NA,NA,1,0,1,1,0,1,0,1,1,0,0,18.75,64.8571428571429,"2017-04-02 UTC--2017-04-08 UTC"
"2017-W15",NA,NA,NA,NA,0,0,0,0,0,0,0,0,0,0,0,19.3392857142857,63.2321428571429,NA
"2017-W16",NA,NA,NA,NA,0,0,0,0,0,0,0,0,0,0,0,20.9982142857143,56.0178571428571,NA
"2017-W17",2.082,NA,NA,2017-04-26,0,0,0,0,0,0,0,0,0,0,0,18.9553571428571,64.8035714285714,NA
"2017-W18",NA,NA,NA,NA,0,0,0,0,0,0,0,0,0,0,0,20.5642857142857,69.8214285714286,NA
"2017-W19",NA,NA,NA,NA,0,0,0,0,0,0,0,0,0,0,0,23.4482142857143,58.1607142857143,NA
"2017-W20",NA,NA,NA,NA,0,0,0,0,0,0,0,0,0,0,0,23.4821428571429,63.8928571428571,NA
"2017-W21",NA,NA,NA,NA,0,0,0,0,0,0,0,0,0,0,0,22.7053571428571,57.0535714285714,NA
"2017-W22",NA,NA,NA,NA,1,1,0,1,0,1,1,0,1,0,0,23.6392857142857,63.9107142857143,"2017-05-28 UTC--2017-06-03 UTC"
"2017-W23",NA,NA,NA,NA,0,0,0,0,0,0,0,0,0,0,0,24.9857142857143,65.3571428571429,NA
"2017-W24",NA,NA,NA,NA,1,0,1,1,0,1,0,1,1,0,0,24.9803571428571,67.75,"2017-06-11 UTC--2017-06-17 UTC"
"2017-W25",NA,NA,NA,NA,0,0,0,0,0,0,0,0,0,0,0,25.5285714285714,66.4464285714286,NA
"2017-W26",NA,NA,NA,NA,0,0,0,0,0,0,0,0,0,0,0,26.8678571428571,71.1607142857143,NA
